,date,incident_id,state,n_killed,n_injured,total
130448,2016-06-12,577157,Florida,50,53,103
217151,2017-11-05,980577,Texas,27,20,47
101531,2015-12-02,456893,California,16,19,35
232745,2018-02-14,1049217,Florida,17,17,34
70511,2015-05-17,341622,Texas,9,18,27
195845,2017-07-01,879953,Arkansas,0,25,25
137328,2016-07-25,611479,Florida,2,19,21
11566,2014-04-02,121031,Texas,4,16,20
73,2013-05-12,486209,Louisiana,0,19,19
92624,2015-10-01,423223,Oregon,10,9,19
218580,2017-11-14,987611,California,6,12,18
239,2013-11-09,493842,Texas,2,16,18
113601,2016-02-25,511436,Kansas,4,14,18
178245,2017-03-26,803054,Ohio,2,15,17
100149,2015-11-22,451495,Louisiana,0,17,17
229405,2018-01-23,1033262,Kentucky,2,14,16
39222,2014-09-28,197384,Florida,0,15,15
135757,2016-07-16,604233,California,1,14,15
151406,2016-10-15,676663,California,4,11,15
134393,2016-07-07,597756,Texas,5,9,14
194,2013-09-16,480366,District of Columbia,11,3,14
142107,2016-08-21,634787,Connecticut,0,13,13
34,2013-03-11,482771,District of Columbia,0,13,13
213,2013-10-05,480765,California,1,12,13
81229,2015-07-23,380162,Louisiana,3,9,12
100823,2015-11-27,454059,Colorado,3,9,12
206418,2017-08-31,924854,Illinois,2,10,12
18242,2014-05-23,138282,California,4,8,12
200,2013-09-19,480521,Illinois,0,12,12
75905,2015-06-20,361212,Michigan,1,11,12
189725,2017-05-28,853901,Alabama,0,12,12
6831,2014-02-20,108626,Florida,0,12,12
111214,2016-02-07,501233,Florida,2,10,12
83892,2015-08-08,390774,Arkansas,1,11,12
165585,2017-01-06,743995,Florida,5,6,11
75984,2015-06-20,361198,Pennsylvania,0,11,11
144774,2016-09-04,647865,Virginia,1,10,11
238,2013-11-07,493035,Michigan,3,7,10
92038,2015-09-27,421014,Georgia,0,10,10
158699,2016-11-27,711597,Louisiana,1,9,10
185933,2017-05-07,838272,Illinois,2,8,10
23794,2014-06-29,152468,Louisiana,1,9,10
207904,2017-09-10,930569,Texas,9,1,10
168924,2017-01-27,761973,Tennessee,0,10,10
188392,2017-05-20,848292,Pennsylvania,0,10,10
75530,2015-06-17,359830,South Carolina,9,0,9
78318,2015-07-05,368732,Indiana,0,9,9
50790,2014-12-21,266424,Illinois,1,8,9
82961,2015-08-02,385779,New York,0,9,9
214815,2017-10-22,966178,Alabama,2,7,9
150357,2016-10-09,672203,Michigan,1,8,9
146810,2016-09-17,657634,District of Columbia,2,7,9
50902,2014-12-22,268394,Florida,0,9,9
23099,2014-06-24,150299,Florida,2,7,9
58843,2015-02-26,298122,Missouri,8,1,9
115010,2016-03-06,517073,California,1,8,9
182323,2017-04-16,821371,Ohio,0,9,9
197098,2017-07-08,886220,Ohio,1,8,9
30692,2014-08-09,171802,Minnesota,1,8,9
111,2013-06-23,489105,Missouri,1,8,9
192357,2017-06-11,864743,Illinois,0,9,9
119,2013-06-30,490226,New York,0,9,9
189720,2017-05-27,853756,Mississippi,8,1,9
210255,2017-09-24,940554,Tennessee,1,8,9
74578,2015-06-11,356065,Connecticut,1,8,9
37527,2014-09-18,192851,Florida,8,0,8
128321,2016-05-29,567614,Texas,2,6,8
15536,2014-05-03,131998,Arkansas,4,4,8
184787,2017-04-30,832679,California,2,6,8
154960,2016-11-05,693374,California,0,8,8
156907,2016-11-17,703245,Tennessee,1,7,8
85963,2015-08-21,399212,North Carolina,0,8,8
208787,2017-09-16,934036,South Carolina,0,8,8
55124,2015-01-24,283041,Nebraska,3,5,8
163,2013-08-07,491698,Texas,4,4,8
79992,2015-07-16,375022,Tennessee,6,2,8
115584,2016-03-09,519541,Pennsylvania,5,3,8
110112,2016-01-30,495940,Arizona,3,5,8
133947,2016-07-04,595482,Arizona,2,6,8
221,2013-10-13,481043,Pennsylvania,0,8,8
6372,2014-02-16,107519,Texas,1,7,8
122526,2016-04-22,545525,Ohio,8,0,8
18244,2014-05-23,140185,Louisiana,1,7,8
39297,2014-09-29,198051,South Carolina,1,7,8
83911,2015-08-08,390526,Texas,8,0,8
36,2013-03-13,482856,New York,6,2,8
272,2013-12-28,496668,Alabama,3,5,8
167250,2017-01-16,752222,Florida,0,8,8
147996,2016-09-24,662342,Maryland,0,8,8
112882,2016-02-20,508640,Michigan,6,2,8
225743,2017-12-31,1017372,Colorado,2,6,8
271,2013-12-26,496634,Louisiana,2,6,8
124415,2016-05-04,553570,Minnesota,1,7,8
124557,2016-05-05,553803,Louisiana,2,6,8
233122,2018-02-17,1052035,Kansas,1,7,8
86343,2015-08-23,400091,California,1,7,8
111091,2016-02-06,500556,Florida,2,6,8
137087,2016-07-24,610584,Ohio,1,7,8
189585,2017-05-27,853119,District of Columbia,1,7,8
111213,2016-02-07,501168,New York,1,7,8
36280,2014-09-11,189562,Michigan,1,7,8
78221,2015-07-05,369014,Louisiana,0,8,8
28235,2014-07-26,163930,Georgia,0,8,8
26,2013-02-24,480443,Georgia,0,8,8
195681,2017-06-30,879412,New York,2,6,8
177812,2017-03-24,802240,Missouri,1,6,7
9,2013-01-23,492151,Maryland,1,6,7
24813,2014-07-05,154721,Indiana,0,7,7
16529,2014-05-10,156823,California,1,6,7
67113,2015-04-25,329322,New York,1,6,7
237536,2018-03-17,1071427,Kentucky,0,7,7
68233,2015-05-03,333576,Ohio,1,6,7
85955,2015-08-21,399367,Ohio,2,5,7
85653,2015-08-19,398361,New York,3,4,7
6412,2014-02-16,107417,Florida,1,6,7
81424,2015-07-24,382413,Pennsylvania,2,5,7
62108,2015-03-22,311348,New Mexico,1,6,7
202242,2017-08-06,907857,California,0,7,7
197428,2017-07-09,886564,Virginia,0,7,7
33347,2014-08-24,180007,California,3,4,7
17581,2014-05-18,135904,Ohio,0,7,7
16598,2014-05-11,134238,Tennessee,0,7,7
15095,2014-04-29,130232,Georgia,1,6,7
62745,2015-03-27,314044,Florida,0,7,7
151,2013-07-26,491265,Florida,7,0,7
61348,2015-03-17,308687,California,3,4,7
158728,2016-11-27,711744,Missouri,0,7,7
161,2013-08-06,491609,Pennsylvania,3,4,7
232234,2018-02-11,1047761,Michigan,4,3,7
206,2013-09-22,480646,Kansas,1,6,7
158,2013-08-04,491473,California,3,4,7
171593,2017-02-12,773002,Missouri,1,6,7
24762,2014-07-05,154834,Virginia,0,7,7
30934,2014-08-10,172304,Louisiana,2,5,7
57,2013-04-24,485811,Illinois,6,1,7
29660,2014-08-03,168551,Texas,0,7,7
29525,2014-08-02,168169,Massachusetts,0,7,7
187231,2017-05-14,843078,Arkansas,1,6,7
218991,2017-11-16,989838,Georgia,0,7,7
163334,2016-12-25,734157,Illinois,3,4,7
192087,2017-06-09,864370,Texas,2,5,7
151104,2016-10-14,676376,Illinois,1,6,7
220171,2017-11-24,994323,Mississippi,1,6,7
56803,2015-02-07,289811,Georgia,5,2,7
28162,2014-07-25,163874,Illinois,1,6,7
136071,2016-07-17,604762,Louisiana,4,3,7
201340,2017-08-01,904026,California,0,7,7
204533,2017-08-20,916848,Illinois,2,5,7
146927,2016-09-17,657136,Florida,1,6,7
93,2013-06-02,487271,Virginia,0,7,7
202646,2017-08-08,909423,Illinois,1,6,7
138006,2016-07-29,617334,Georgia,0,7,7
53474,2015-01-11,276845,North Carolina,2,5,7
164496,2017-01-01,739766,Florida,0,7,7
16572,2014-05-11,134162,California,1,6,7
25476,2014-07-09,156670,Texas,6,1,7
148309,2016-09-26,663106,Texas,1,6,7
10349,2014-03-23,117914,California,0,7,7
139857,2016-08-08,624273,Florida,0,7,7
41,2013-03-21,483737,Illinois,0,7,7
177478,2017-03-21,799987,Texas,0,7,7
38,2013-03-16,482926,California,0,7,7
249,2013-11-25,495145,California,0,7,7
82830,2015-08-02,386140,Maryland,0,7,7
23622,2014-06-28,152960,California,0,7,7
94,2013-06-02,487435,Georgia,0,7,7
71704,2015-05-24,345749,Michigan,0,7,7
132300,2016-06-25,587755,Texas,2,5,7
153963,2016-10-30,688577,New York,2,5,7
30838,2014-08-10,172180,California,0,7,7
121707,2016-04-17,543108,Texas,1,6,7
125,2013-07-04,490351,Michigan,1,6,7
224,2013-10-21,481268,Pennsylvania,2,5,7
179738,2017-04-03,811089,Texas,0,7,7
115103,2016-03-06,517058,Massachusetts,1,6,7
218262,2017-11-12,986236,Indiana,0,7,7
200360,2017-07-26,898631,North Carolina,1,6,7
194323,2017-06-22,873847,Georgia,1,6,7
143125,2016-08-27,640500,Alabama,1,6,7
19829,2014-06-02,142076,Illinois,0,7,7
95,2013-06-07,489581,California,6,1,7
49958,2014-12-15,263556,Pennsylvania,7,0,7
163204,2016-12-24,732927,North Carolina,0,7,7
146720,2016-09-16,657023,Pennsylvania,2,5,7
133756,2016-07-04,595166,New York,0,7,7
231,2013-10-27,492570,California,1,6,7
54426,2015-01-19,281039,Texas,2,5,7
79802,2015-07-15,375412,Ohio,0,7,7
22,2013-02-19,480358,California,4,3,7
193575,2017-06-18,869968,South Carolina,0,7,7
76230,2015-06-22,361948,Pennsylvania,0,7,7
59583,2015-03-04,300860,California,3,4,7
152574,2016-10-22,682298,California,0,7,7
116010,2016-03-12,521176,Florida,0,6,6
40348,2014-10-05,201052,Michigan,1,5,6
56068,2015-02-01,287529,New York,0,6,6
85272,2015-08-16,395844,Texas,0,6,6
20921,2014-06-09,156245,New Jersey,0,6,6
270,2013-12-26,496584,Louisiana,3,3,6
183092,2017-04-21,828883,Louisiana,1,5,6
95089,2015-10-19,433146,Illinois,0,6,6
276,2013-12-31,496684,New York,0,6,6
184631,2017-04-29,831800,California,1,5,6
49594,2014-12-12,262147,Georgia,3,3,6
179575,2017-04-02,809978,Illinois,2,4,6
205978,2017-08-28,922184,New Mexico,2,4,6
202259,2017-08-06,907555,New York,0,6,6
90315,2015-09-17,418318,South Dakota,6,0,6
90865,2015-09-20,417013,Oklahoma,0,6,6
59180,2015-03-01,299344,Michigan,1,5,6
201080,2017-07-30,901549,Virginia,1,5,6
174240,2017-02-28,785262,Ohio,0,6,6
50881,2014-12-22,282186,New York,4,2,6
90866,2015-09-20,416872,Illinois,1,5,6
20648,2014-06-07,143723,South Carolina,1,5,6
178561,2017-03-27,804115,Florida,2,4,6
7383,2014-02-25,109957,Virginia,5,1,6
201379,2017-08-01,904106,Washington,0,6,6
178297,2017-03-26,803822,Texas,2,4,6
52684,2015-01-04,273535,Virginia,2,4,6
177079,2017-03-19,797553,Kentucky,1,5,6
56917,2015-02-08,290510,Tennessee,0,6,6
89765,2015-09-13,413001,Florida,1,5,6
48400,2014-12-02,227011,Missouri,1,5,6
182049,2017-04-15,821400,Alabama,0,6,6
89470,2015-09-12,412529,Minnesota,0,6,6
43312,2014-10-24,210363,Washington,5,1,6
61795,2015-03-20,468151,Texas,1,5,6
168105,2017-01-21,756801,Georgia,0,6,6
168656,2017-01-25,760259,Illinois,0,6,6
56500,2015-02-05,289146,Ohio,3,3,6
111181,2016-02-07,501256,Mississippi,2,4,6
61510,2015-03-18,308728,Arizona,1,5,6
46581,2014-11-16,224746,Texas,0,6,6
109520,2016-01-27,494378,Virginia,6,0,6
88768,2015-09-07,409732,Indiana,2,4,6
208319,2017-09-13,932526,Tennessee,1,5,6
47149,2014-11-21,223582,Pennsylvania,0,6,6
238110,2018-03-21,1074886,California,1,5,6
6834,2014-02-20,108649,California,4,2,6
54985,2015-01-23,283115,Massachusetts,0,6,6
105589,2015-12-31,476321,Louisiana,0,6,6
171247,2017-02-10,772067,Louisiana,1,5,6
180472,2017-04-07,814094,Illinois,1,5,6
89468,2015-09-12,412487,New York,2,4,6
47759,2014-11-26,225036,California,0,6,6
191828,2017-06-08,863075,Louisiana,0,6,6
8538,2014-03-08,113214,Illinois,0,6,6
218127,2017-11-11,986092,Louisiana,1,5,6
231510,2018-02-05,1043447,Colorado,2,4,6
2477,2014-01-16,97407,Oklahoma,2,4,6
97,2013-06-10,487659,Missouri,0,6,6
152699,2016-10-23,683142,Oklahoma,1,5,6
105,2013-06-21,488505,Virginia,0,6,6
231712,2018-02-07,1044234,Florida,3,3,6
153591,2016-10-28,688429,Mississippi,0,6,6
80038,2015-07-16,375922,Maine,2,4,6
117,2013-06-28,490115,Illinois,0,6,6
218165,2017-11-11,985832,North Carolina,1,5,6
153932,2016-10-30,689020,Maryland,3,3,6
11978,2014-04-05,122136,Illinois,1,5,6
30917,2014-08-10,172288,Georgia,0,6,6
6288,2014-02-15,107447,Florida,0,6,6
237404,2018-03-17,1072200,Georgia,2,4,6
154279,2016-11-01,691113,Tennessee,1,5,6
131213,2016-06-18,583210,Ohio,2,4,6
31891,2014-08-16,175788,Utah,0,6,6
70400,2015-05-16,341962,Illinois,0,6,6
236261,2018-03-09,1067061,Indiana,0,6,6
129470,2016-06-05,572766,Arizona,2,4,6
129338,2016-06-05,572696,Florida,3,3,6
29475,2014-08-02,168307,Pennsylvania,1,5,6
151408,2016-10-15,676686,Illinois,1,5,6
156195,2016-11-12,699033,California,1,5,6
226563,2018-01-05,1021788,Mississippi,0,6,6
143604,2016-08-29,641732,New Jersey,1,5,6
145877,2016-09-11,652584,Missouri,0,6,6
145881,2016-09-11,653077,Louisiana,1,5,6
143418,2016-08-28,641419,Texas,0,6,6
24811,2014-07-05,154803,Texas,0,6,6
143137,2016-08-27,640203,Florida,2,4,6
191341,2017-06-05,859875,Florida,6,0,6
146910,2016-09-17,659289,Florida,0,6,6
77161,2015-06-28,365399,Delaware,0,6,6
77205,2015-06-28,367099,Illinois,0,6,6
192815,2017-06-14,866933,California,4,2,6
220146,2017-11-24,995015,Ohio,1,5,6
148127,2016-09-25,664674,Texas,2,4,6
189950,2017-05-28,853796,New Jersey,1,5,6
192872,2017-06-14,866739,Virginia,1,5,6
51,2013-04-14,484307,Arizona,2,4,6
26576,2014-07-16,159753,California,3,3,6
231176,2018-02-03,1042280,Ohio,1,5,6
226814,2018-01-07,1022067,Alabama,1,5,6
27410,2014-07-21,161302,New Jersey,0,6,6
135865,2016-07-16,604175,Tennessee,0,6,6
23786,2014-06-29,152693,California,1,5,6
80536,2015-07-19,377047,Kentucky,0,6,6
30861,2014-08-10,172205,District of Columbia,0,6,6
93859,2015-10-10,428215,Tennessee,0,6,6
193,2013-09-15,480071,Washington,0,6,6
124694,2016-05-06,554133,Maryland,3,3,6
19735,2014-06-01,141382,Illinois,1,5,6
185,2013-09-07,479709,Indiana,2,4,6
216,2013-10-06,480961,Pennsylvania,1,5,6
159235,2016-11-30,715101,Maryland,2,4,6
34871,2014-09-03,185430,California,0,6,6
68253,2015-05-03,333584,Texas,0,6,6
122425,2016-04-22,546022,Georgia,6,0,6
159672,2016-12-02,717616,New Jersey,0,6,6
121456,2016-04-16,541987,Florida,2,4,6
1803,2014-01-12,95500,Louisiana,0,6,6
159747,2016-12-03,717873,California,0,6,6
214048,2017-10-18,962359,Maryland,3,3,6
80759,2015-07-20,377878,New York,0,6,6
36832,2014-09-14,190599,Alaska,0,6,6
184841,2017-04-30,832309,South Carolina,1,5,6
207,2013-09-24,480691,West Virginia,0,6,6
205,2013-09-22,480669,Michigan,2,4,6
225,2013-10-26,492366,Connecticut,1,5,6
67400,2015-04-27,330611,New York,2,4,6
13919,2014-04-20,127045,Illinois,0,6,6
128325,2016-05-29,567673,New Jersey,0,6,6
215685,2017-10-27,974051,Kentucky,0,6,6
81148,2015-07-22,382230,Missouri,0,6,6
158481,2016-11-26,710732,Illinois,1,5,6
8599,2014-03-09,113247,Texas,0,6,6
163331,2016-12-25,733599,New York,1,5,6
158163,2016-11-24,709370,Kentucky,2,4,6
189085,2017-05-24,852174,California,0,5,5
78124,2015-07-04,368987,Massachusetts,1,4,5
6462,2014-02-16,107433,Florida,1,4,5
76094,2015-06-21,361708,Kentucky,1,4,5
92079,2015-09-28,422035,Illinois,2,3,5
93283,2015-10-06,426256,Maryland,0,5,5
191600,2017-06-06,861307,Utah,3,2,5
184638,2017-04-29,832290,California,0,5,5
83214,2015-08-04,389149,Missouri,1,4,5
82928,2015-08-02,386066,Georgia,0,5,5
92089,2015-09-28,422064,Illinois,3,2,5
77110,2015-06-28,365391,Michigan,0,5,5
92093,2015-09-28,421650,Ohio,0,5,5
189849,2017-05-28,853920,Mississippi,0,5,5
85219,2015-08-16,395718,South Carolina,0,5,5
83071,2015-08-03,387194,New York,0,5,5
16858,2014-05-13,134823,Georgia,0,5,5
184836,2017-04-30,833128,Florida,0,5,5
184747,2017-04-30,832528,Kansas,4,1,5
191040,2017-06-03,858719,Louisiana,3,2,5
82829,2015-08-02,385824,Illinois,1,4,5
190818,2017-06-02,858378,Texas,2,3,5
92695,2015-10-02,424224,Maryland,1,4,5
87439,2015-08-30,404167,Tennessee,1,4,5
91406,2015-09-24,419718,Illinois,0,5,5
89451,2015-09-11,412557,North Carolina,0,5,5
81918,2015-07-27,382459,Illinois,0,5,5
80298,2015-07-17,376211,Illinois,0,5,5
83899,2015-08-08,390914,North Carolina,2,3,5
17423,2014-05-17,136163,District of Columbia,0,5,5
81805,2015-07-26,381814,Missouri,2,3,5
81695,2015-07-26,381820,Indiana,0,5,5
80415,2015-07-18,376702,Oregon,1,4,5
235364,2018-03-04,1062466,Illinois,1,4,5
89196,2015-09-10,412040,Minnesota,5,0,5
180487,2017-04-07,813821,Texas,5,0,5
6340,2014-02-15,107403,Nevada,0,5,5
80449,2015-07-18,390936,California,0,5,5
81096,2015-07-22,379166,Georgia,5,0,5
184943,2017-05-01,833152,Texas,2,3,5
180459,2017-04-07,813943,Minnesota,4,1,5
87318,2015-08-30,404173,Michigan,1,4,5
91233,2015-09-23,419250,Louisiana,0,5,5
179351,2017-04-01,809499,Oklahoma,2,3,5
179332,2017-04-01,809048,Florida,1,4,5
6077,2014-02-12,106394,Indiana,0,5,5
6421,2014-02-16,108659,Texas,1,4,5
187249,2017-05-14,843172,Florida,0,5,5
79515,2015-07-13,373768,California,1,4,5
178141,2017-03-25,802926,Tennessee,1,4,5
236423,2018-03-11,1067296,Michigan,0,5,5
179638,2017-04-02,809683,Iowa,0,5,5
187176,2017-05-14,843045,Illinois,0,5,5
79917,2015-07-15,374602,Georgia,0,5,5
179423,2017-04-01,809815,California,0,5,5
87172,2015-08-29,404238,Tennessee,3,2,5
6414,2014-02-16,107673,Indiana,0,5,5
80086,2015-07-16,375773,Texas,0,5,5
79467,2015-07-12,373095,Illinois,2,3,5
79849,2015-07-15,374630,South Carolina,4,1,5
177963,2017-03-24,802425,California,1,4,5
133121,2016-06-29,592207,Nevada,5,0,5
128537,2016-05-30,568528,Maryland,0,5,5
156074,2016-11-12,699303,Connecticut,0,5,5
232157,2018-02-10,1046961,Kentucky,5,0,5
130372,2016-06-11,577574,New Mexico,5,0,5
155715,2016-11-09,696917,Washington,0,5,5
130433,2016-06-11,577073,California,3,2,5
130656,2016-06-13,579786,New York,0,5,5
130664,2016-06-13,580279,Illinois,0,5,5
155098,2016-11-05,693401,South Carolina,0,5,5
154961,2016-11-05,693290,Illinois,0,5,5
154432,2016-11-02,692025,Arkansas,1,4,5
131965,2016-06-22,586122,Georgia,1,4,5
132211,2016-06-24,587769,Maryland,3,2,5
132216,2016-06-24,587735,Connecticut,0,5,5
132480,2016-06-26,588867,Georgia,1,4,5
132565,2016-06-26,589159,North Carolina,0,5,5
153843,2016-10-30,688592,Texas,0,5,5
128490,2016-05-30,568745,California,0,5,5
156227,2016-11-13,700232,California,3,2,5
128300,2016-05-29,568721,Washington,0,5,5
123899,2016-05-01,551053,Tennessee,0,5,5
122695,2016-04-23,546550,Kansas,1,4,5
122722,2016-04-24,547319,Illinois,2,3,5
122728,2016-04-24,546760,Virginia,0,5,5
122907,2016-04-25,547827,Florida,0,5,5
160035,2016-12-05,719128,New Mexico,4,1,5
123192,2016-04-26,548333,Maryland,1,4,5
123657,2016-04-29,550619,California,0,5,5
124644,2016-05-06,555873,Michigan,1,4,5
156287,2016-11-13,699605,Florida,3,2,5
125490,2016-05-11,557479,Illinois,0,5,5
125530,2016-05-11,557589,Alabama,1,4,5
232564,2018-02-13,1049024,Louisiana,2,3,5
125993,2016-05-14,559042,Georgia,0,5,5
126150,2016-05-15,565244,Georgia,5,0,5
157813,2016-11-22,708392,Florida,1,4,5
127351,2016-05-23,564470,New Jersey,0,5,5
153784,2016-10-29,689009,California,0,5,5
133214,2016-06-30,592724,Illinois,1,4,5
94629,2015-10-16,431678,Hawaii,0,5,5
133687,2016-07-03,594051,Louisiana,2,3,5
139438,2016-08-06,623195,Pennsylvania,5,0,5
230126,2018-01-27,1037541,California,0,5,5
147850,2016-09-23,661703,Washington,5,0,5
230198,2018-01-28,1037529,Pennsylvania,5,0,5
141024,2016-08-14,629415,Minnesota,0,5,5
11173,2014-03-30,120621,Mississippi,0,5,5
230243,2018-01-28,1037515,Indiana,2,3,5
11159,2014-03-30,120303,North Carolina,0,5,5
141876,2016-08-20,634731,Washington,0,5,5
141982,2016-08-20,634819,Alabama,5,0,5
142821,2016-08-25,640901,New Jersey,0,5,5
146137,2016-09-13,654087,Indiana,3,2,5
143518,2016-08-28,640861,Alabama,0,5,5
143575,2016-08-29,684389,California,5,0,5
145873,2016-09-11,652561,Michigan,0,5,5
145866,2016-09-11,652606,North Carolina,0,5,5
145460,2016-09-08,651434,Arkansas,1,4,5
138450,2016-07-31,617607,Texas,1,4,5
138227,2016-07-30,618321,Georgia,0,5,5
138162,2016-07-30,617712,Missouri,0,5,5
151686,2016-10-17,678438,Illinois,1,4,5
133835,2016-07-04,595069,Texas,3,2,5
153007,2016-10-25,684130,Virginia,2,3,5
151994,2016-10-19,679999,Virginia,1,4,5
134429,2016-07-07,597176,Tennessee,1,4,5
134995,2016-07-11,600398,Michigan,3,2,5
135087,2016-07-11,600798,Maryland,0,5,5
135266,2016-07-13,602810,Georgia,0,5,5
151364,2016-10-15,677293,Alabama,0,5,5
137928,2016-07-28,615109,New York,0,5,5
135712,2016-07-16,604275,Ohio,0,5,5
135804,2016-07-16,604459,Texas,0,5,5
136719,2016-07-21,609402,Illinois,0,5,5
136817,2016-07-22,610402,Illinois,0,5,5
149515,2016-10-04,669777,Louisiana,3,2,5
136987,2016-07-23,610379,Texas,4,1,5
149288,2016-10-02,667984,Texas,1,4,5
161129,2016-12-11,723643,Florida,1,4,5
161146,2016-12-11,723292,Maryland,0,5,5
121994,2016-04-19,543441,Alabama,1,4,5
121932,2016-04-19,543132,Illinois,1,4,5
100099,2015-11-22,451305,New York,0,5,5
173868,2017-02-26,783623,Indiana,1,4,5
173774,2017-02-25,783102,Ohio,2,3,5
173730,2017-02-25,783090,Florida,1,4,5
100257,2015-11-23,452007,Ohio,4,1,5
100264,2015-11-23,452120,Minnesota,0,5,5
101109,2015-11-29,455394,Illinois,0,5,5
172931,2017-02-20,778941,Ohio,0,5,5
102024,2015-12-06,460386,Nebraska,2,3,5
172844,2017-02-19,777996,Iowa,0,5,5
227982,2018-01-14,1026804,Alabama,1,4,5
172553,2017-02-18,777389,Minnesota,0,5,5
172170,2017-02-15,775531,Illinois,3,2,5
7784,2014-03-01,111095,Pennsylvania,1,4,5
171559,2017-02-12,773908,Florida,0,5,5
104076,2015-12-20,468787,Florida,1,4,5
104077,2015-12-20,468968,North Carolina,1,4,5
174652,2017-03-03,787435,California,0,5,5
99566,2015-11-18,449814,California,0,5,5
99184,2015-11-15,448419,Texas,5,0,5
96049,2015-10-25,436240,District of Columbia,0,5,5
94828,2015-10-17,432466,Florida,1,4,5
177595,2017-03-22,800828,Louisiana,4,1,5
177518,2017-03-22,800363,Wisconsin,5,0,5
16453,2014-05-10,134052,Georgia,2,3,5
227615,2018-01-12,1025873,North Carolina,0,5,5
95975,2015-10-25,436234,Arizona,1,4,5
95976,2015-10-25,436202,North Carolina,0,5,5
176940,2017-03-18,797125,Michigan,3,2,5
98901,2015-11-13,446996,Florida,4,1,5
96201,2015-10-26,437323,Indiana,0,5,5
96372,2015-10-27,437836,Texas,0,5,5
227733,2018-01-12,1025673,Tennessee,3,2,5
97348,2015-11-03,441681,Florida,2,3,5
174821,2017-03-04,787875,Kansas,1,4,5
234555,2018-02-26,1057518,Michigan,5,0,5
98759,2015-11-12,446738,California,3,2,5
170862,2017-02-08,769889,Ohio,1,4,5
228134,2018-01-15,1042072,Florida,0,5,5
106852,2016-01-08,481900,Illinois,1,4,5
117088,2016-03-19,525464,Florida,1,4,5
114288,2016-03-01,514780,Florida,1,4,5
115145,2016-03-07,518436,Kansas,5,0,5
115394,2016-03-08,518266,Texas,2,3,5
115956,2016-03-11,520290,New Jersey,0,5,5
233203,2018-02-18,1052372,Texas,0,5,5
164767,2017-01-01,739405,Illinois,1,4,5
116548,2016-03-15,523044,Georgia,0,5,5
233160,2018-02-17,1051407,Tennessee,0,5,5
166507,2017-01-12,749361,Missouri,3,2,5
164516,2017-01-01,743282,Mississippi,0,5,5
13969,2014-04-20,127413,Illinois,0,5,5
164113,2016-12-30,738041,Ohio,0,5,5
163720,2016-12-28,736690,Georgia,1,4,5
162134,2016-12-17,727759,Illinois,5,0,5
121381,2016-04-16,542259,Michigan,1,4,5
121907,2016-04-18,543271,Michigan,1,4,5
113981,2016-02-28,513549,Michigan,0,5,5
113797,2016-02-26,512073,Washington,5,0,5
170678,2017-02-07,769859,Arkansas,1,4,5
168297,2017-01-22,757158,Texas,3,2,5
107415,2016-01-11,483750,Delaware,1,4,5
109246,2016-01-25,493085,California,1,4,5
109451,2016-01-26,493536,Washington,2,3,5
169373,2017-01-29,763313,Louisiana,1,4,5
228308,2018-01-16,1027999,South Carolina,1,4,5
14809,2014-04-27,129730,New York,0,5,5
168784,2017-01-26,760482,Georgia,2,3,5
112051,2016-02-14,505420,Alabama,0,5,5
166950,2017-01-15,751367,Mississippi,1,4,5
168093,2017-01-21,756526,Florida,0,5,5
8193,2014-03-05,112450,Indiana,1,4,5
8199,2014-03-05,112415,South Carolina,3,2,5
14605,2014-04-25,128871,Tennessee,2,3,5
112975,2016-02-20,508113,Mississippi,2,3,5
113143,2016-02-21,509707,Texas,0,5,5
113402,2016-02-23,509897,Arizona,5,0,5
167849,2017-01-20,757955,Mississippi,1,4,5
144810,2016-09-05,648884,Illinois,2,3,5
53405,2015-01-11,276766,California,0,5,5
130,2013-07-07,490893,California,1,4,5
113,2013-06-23,489129,Virginia,1,4,5
30318,2014-08-07,170724,Wisconsin,0,5,5
55066,2015-01-24,282956,New York,4,1,5
53694,2015-01-13,298773,Virginia,0,5,5
230,2013-10-27,492393,North Carolina,1,4,5
115,2013-06-25,489987,Illinois,1,4,5
203326,2017-08-13,912805,Pennsylvania,0,5,5
203433,2017-08-13,912848,California,0,5,5
218289,2017-11-12,987134,California,0,5,5
4199,2014-01-28,101785,Wisconsin,0,5,5
52352,2015-01-02,273965,Georgia,1,4,5
128,2013-07-07,490772,Illinois,0,5,5
52186,2015-01-01,272016,Tennessee,0,5,5
204428,2017-08-19,916551,Ohio,1,4,5
31296,2014-08-12,173628,Georgia,2,3,5
206936,2017-09-03,926766,California,2,3,5
4111,2014-01-27,113665,Washington,1,4,5
140,2013-07-13,490932,New Jersey,1,4,5
141,2013-07-14,491037,Michigan,0,5,5
142,2013-07-14,491001,Kansas,1,4,5
50888,2014-12-22,267721,Illinois,0,5,5
50873,2014-12-22,267653,Georgia,2,3,5
146,2013-07-20,491181,New York,0,5,5
1831,2014-01-12,95579,Illinois,0,5,5
50767,2014-12-21,268910,Mississippi,1,4,5
205671,2017-08-27,921733,California,1,4,5
49911,2014-12-14,263376,Florida,1,4,5
49785,2014-12-13,263382,Florida,0,5,5
216857,2017-11-03,980401,Louisiana,1,4,5
156,2013-08-02,491416,New Jersey,2,3,5
2502,2014-01-16,97365,Utah,5,0,5
56146,2015-02-01,287031,New York,1,4,5
109,2013-06-23,489061,Tennessee,1,4,5
56630,2015-02-06,290098,Oklahoma,1,4,5
28357,2014-07-26,164513,Maine,5,0,5
28434,2014-07-27,165089,Missouri,0,5,5
60824,2015-03-14,306897,Georgia,0,5,5
60759,2015-03-13,305907,Mississippi,2,3,5
28596,2014-07-28,165856,Pennsylvania,1,4,5
199130,2017-07-19,894197,Texas,2,3,5
199183,2017-07-19,893690,Virginia,0,5,5
199533,2017-07-22,896149,Ohio,0,5,5
28977,2014-07-30,176329,North Carolina,3,2,5
60345,2015-03-10,304238,Georgia,0,5,5
86,2013-05-25,486998,Virginia,1,4,5
200498,2017-07-27,900387,Illinois,1,4,5
200752,2017-07-29,901083,New York,1,4,5
200856,2017-07-29,901000,North Carolina,2,3,5
98,2013-06-10,487670,Illinois,1,4,5
99,2013-06-14,487715,North Carolina,0,5,5
58428,2015-02-22,296215,Texas,4,1,5
29735,2014-08-03,169024,Tennessee,0,5,5
29766,2014-08-03,168786,Missouri,0,5,5
58386,2015-02-22,296121,Georgia,3,2,5
29791,2014-08-03,168844,Virginia,5,0,5
20730,2014-06-08,181998,Nevada,5,0,5
57714,2015-02-15,293883,California,0,5,5
29911,2014-08-04,169326,Georgia,0,5,5
20799,2014-06-08,144524,Florida,5,0,5
20801,2014-06-08,144565,Alabama,1,4,5
106,2013-06-21,488547,North Carolina,0,5,5
107,2013-06-22,488833,Maryland,1,4,5
201870,2017-08-04,906509,Montana,3,2,5
157,2013-08-03,491461,Michigan,0,5,5
32674,2014-08-20,178425,Tennessee,0,5,5
76,2013-05-15,486327,Michigan,1,4,5
211311,2017-10-01,945990,Kansas,3,2,5
199,2013-09-18,480470,Tennessee,1,4,5
269,2013-12-25,495588,New Jersey,3,2,5
35576,2014-09-06,186488,Georgia,0,5,5
41625,2014-10-14,205726,Georgia,3,2,5
202,2013-09-20,480605,Texas,5,0,5
211071,2017-09-29,945100,California,0,5,5
225108,2017-12-26,1014855,New Mexico,0,5,5
264,2013-12-21,495548,New Jersey,1,4,5
224914,2017-12-24,1014052,Alabama,1,4,5
262,2013-12-15,495530,Texas,0,5,5
41239,2014-10-11,204236,New York,0,5,5
225102,2017-12-26,1015336,Florida,0,5,5
40809,2014-10-08,203757,Oklahoma,1,4,5
36994,2014-09-15,191416,Louisiana,0,5,5
255,2013-11-30,495323,Michigan,0,5,5
23277,2014-06-26,151659,Wisconsin,0,5,5
219,2013-10-12,481029,Oklahoma,0,5,5
3260,2014-01-21,98836,New Jersey,2,3,5
248,2013-11-23,494155,Oklahoma,4,1,5
38828,2014-09-26,198064,South Carolina,1,4,5
239582,2018-03-31,1082273,New Jersey,0,5,5
22593,2014-06-21,150344,Tennessee,0,5,5
212206,2017-10-06,953156,Illinois,0,5,5
38898,2014-09-27,197287,Missouri,0,5,5
244,2013-11-20,494072,Texas,3,2,5
227,2013-10-26,492325,Arizona,5,0,5
242,2013-11-11,493882,New York,4,1,5
39488,2014-09-30,198488,Michigan,0,5,5
212685,2017-10-09,955268,Texas,0,5,5
234,2013-11-03,492985,California,0,5,5
198,2013-09-17,480462,Florida,0,5,5
35159,2014-09-04,185393,Michigan,0,5,5
195,2013-09-17,480394,California,2,3,5
191,2013-09-15,480104,Colorado,0,5,5
3822,2014-01-25,100434,Illinois,1,4,5
48425,2014-12-02,226983,Virginia,0,5,5
48285,2014-12-01,226466,West Virginia,5,0,5
224816,2017-12-24,1013983,Mississippi,0,5,5
48154,2014-11-30,226534,Tennessee,0,5,5
48071,2014-11-29,225903,Georgia,3,2,5
167,2013-08-11,491749,Virginia,1,4,5
47872,2014-11-27,226018,Texas,2,3,5
47394,2014-11-23,224131,Colorado,1,4,5
47337,2014-11-22,223651,Ohio,4,1,5
47314,2014-11-22,223799,South Dakota,4,1,5
174,2013-08-18,491898,South Carolina,1,4,5
23125,2014-06-25,151475,Massachusetts,0,5,5
176,2013-08-19,491965,Illinois,1,4,5
34460,2014-08-31,183432,California,0,5,5
181,2013-08-25,492276,Florida,4,1,5
46547,2014-11-16,221554,Ohio,1,4,5
208891,2017-09-17,935928,Virginia,1,4,5
45556,2014-11-08,217451,North Carolina,1,4,5
209516,2017-09-20,939482,Indiana,0,5,5
45418,2014-11-08,217831,California,0,5,5
209971,2017-09-23,940068,Illinois,0,5,5
210002,2017-09-23,939834,California,1,4,5
186,2013-09-10,479734,Connecticut,1,4,5
34756,2014-09-02,184507,California,0,5,5
44541,2014-11-01,214127,Washington,0,5,5
44129,2014-10-29,212884,Tennessee,0,5,5
34767,2014-09-02,185196,Mississippi,2,3,5
43279,2014-10-24,210151,California,2,3,5
28343,2014-07-26,163940,Tennessee,1,4,5
232,2013-10-29,492914,South Carolina,5,0,5
69760,2015-05-12,340280,Maryland,1,4,5
68317,2015-05-03,333750,Wisconsin,4,1,5
72872,2015-05-31,349976,Connecticut,0,5,5
68010,2015-05-01,332732,Wisconsin,2,3,5
44,2013-03-30,483835,California,3,2,5
20,2013-02-11,480327,Delaware,3,2,5
19,2013-02-11,480311,California,1,4,5
73637,2015-06-05,353382,Iowa,0,5,5
45,2013-03-31,483817,Washington,3,2,5
73692,2015-06-06,353037,Illinois,0,5,5
15,2013-02-02,479573,Tennessee,0,5,5
46,2013-04-06,483861,South Carolina,1,4,5
73729,2015-06-06,353536,New York,1,4,5
73910,2015-06-07,353854,Montana,5,0,5
66181,2015-04-18,325445,Pennsylvania,0,5,5
66139,2015-04-18,327341,Alabama,0,5,5
5507,2014-02-07,104721,Florida,0,5,5
192937,2017-06-15,868363,New Mexico,5,0,5
196372,2017-07-04,883015,Ohio,2,3,5
65810,2015-04-16,324424,Arizona,5,0,5
20029,2014-06-03,142818,Georgia,1,4,5
64198,2015-04-05,318297,Indiana,0,5,5
13,2013-01-26,479554,District of Columbia,0,5,5
21,2013-02-12,480344,Utah,4,1,5
223395,2017-12-15,1008310,California,0,5,5
74963,2015-06-13,357732,Georgia,1,4,5
72797,2015-05-31,350182,Georgia,3,2,5
194590,2017-06-24,874613,Florida,1,4,5
194577,2017-06-24,875322,New York,0,5,5
70657,2015-05-18,342589,Florida,1,4,5
33,2013-03-10,481237,Missouri,0,5,5
70416,2015-05-16,341465,Wisconsin,0,5,5
70363,2015-05-16,341232,Maryland,0,5,5
25219,2014-07-08,156468,Rhode Island,0,5,5
25169,2014-07-07,155876,Illinois,0,5,5
222627,2017-12-10,1005562,California,2,3,5
69698,2015-05-12,339229,Arizona,5,0,5
71734,2015-05-24,345681,Massachusetts,0,5,5
25041,2014-07-07,155943,California,1,4,5
195072,2017-06-27,877295,Illinois,0,5,5
25851,2014-07-12,157857,California,3,2,5
69321,2015-05-10,337855,Ohio,1,4,5
71809,2015-05-25,346097,Illinois,1,4,5
193527,2017-06-18,870095,Missouri,3,2,5
39,2013-03-17,482934,California,2,3,5
72396,2015-05-28,348620,Illinois,0,5,5
40,2013-03-17,482942,Florida,0,5,5
193403,2017-06-17,869357,Ohio,1,4,5
74939,2015-06-13,357701,New York,0,5,5
196368,2017-07-04,882321,Virginia,1,4,5
26099,2014-07-13,158306,Washington,0,5,5
24639,2014-07-05,158055,Illinois,0,5,5
56,2013-04-22,485746,Louisiana,0,5,5
63673,2015-04-02,316795,Maryland,0,5,5
4993,2014-02-03,103698,Indiana,3,2,5
7,2013-01-21,479374,Louisiana,0,5,5
6,2013-01-19,479363,New Mexico,5,0,5
1891,2014-01-12,95550,Alabama,0,5,5
60,2013-04-28,485874,North Carolina,0,5,5
74997,2015-06-13,357164,Ohio,4,1,5
54,2013-04-21,484333,Washington,5,0,5
24612,2014-07-04,154844,Virginia,0,5,5
221228,2017-11-30,998843,Michigan,1,4,5
64,2013-05-02,486005,New Jersey,0,5,5
66,2013-05-05,486056,California,0,5,5
24211,2014-07-02,156834,Pennsylvania,0,5,5
69,2013-05-11,486142,Indiana,5,0,5
72,2013-05-12,486153,Arizona,0,5,5
24776,2014-07-05,154971,Oregon,1,4,5
62176,2015-03-23,311922,Tennessee,1,4,5
196696,2017-07-05,883058,Maine,4,1,5
52,2013-04-14,484287,Kentucky,1,4,5
26178,2014-07-14,158387,California,1,4,5
64184,2015-04-05,318221,Kentucky,1,4,5
26163,2014-07-13,158589,Connecticut,0,5,5
12,2013-01-26,479561,Louisiana,2,3,5
145949,2016-09-11,652759,New Jersey,1,3,4
222954,2017-12-12,1006446,Texas,0,4,4
161099,2016-12-11,725338,North Carolina,0,4,4
214646,2017-10-21,965077,Florida,0,4,4
2956,2014-01-19,98411,Iowa,0,4,4
162929,2016-12-23,732941,North Carolina,0,4,4
163032,2016-12-23,732263,Alabama,1,3,4
145930,2016-09-11,652642,Indiana,3,1,4
162764,2016-12-22,731144,Texas,2,2,4
214639,2017-10-21,965756,Tennessee,0,4,4
212831,2017-10-10,956959,California,0,4,4
214590,2017-10-21,965066,Florida,0,4,4
146902,2016-09-17,657151,Indiana,2,2,4
9147,2014-03-14,115012,New York,0,4,4
163042,2016-12-23,732574,Illinois,0,4,4
214791,2017-10-22,966153,Connecticut,0,4,4
215055,2017-10-23,966895,California,2,2,4
212784,2017-10-10,956942,California,0,4,4
213622,2017-10-15,959126,Arizona,1,3,4
157207,2016-11-18,704568,Illinois,0,4,4
3083,2014-01-20,104902,Virginia,0,4,4
157751,2016-11-22,708421,California,1,3,4
144920,2016-09-05,648490,Pennsylvania,0,4,4
157996,2016-11-23,708777,Mississippi,0,4,4
161000,2016-12-11,723649,New York,0,4,4
145394,2016-09-08,651957,Texas,4,0,4
158095,2016-11-24,709276,New York,1,3,4
147043,2016-09-18,658226,Pennsylvania,0,4,4
158253,2016-11-25,710885,Alaska,4,0,4
163125,2016-12-24,733176,North Carolina,4,0,4
158334,2016-11-25,710467,Louisiana,0,4,4
158790,2016-11-28,712776,California,0,4,4
162055,2016-12-17,728286,North Carolina,0,4,4
223028,2017-12-12,1006150,Kentucky,0,4,4
160641,2016-12-09,725323,Texas,4,0,4
213026,2017-10-11,957562,Ohio,4,0,4
161317,2016-12-12,724930,Louisiana,0,4,4
160075,2016-12-05,720291,Kentucky,1,3,4
161694,2016-12-15,726945,North Carolina,2,2,4
213096,2017-10-12,957980,California,2,2,4
223528,2017-12-16,1009629,Mississippi,0,4,4
146359,2016-09-14,655512,Texas,1,3,4
213977,2017-10-17,962155,New York,0,4,4
159920,2016-12-04,717897,Indiana,1,3,4
1991,2014-01-13,96185,Michigan,0,4,4
9035,2014-03-13,114471,Tennessee,0,4,4
213888,2017-10-16,962623,Mississippi,1,3,4
146372,2016-09-14,655016,Wyoming,2,2,4
161240,2016-12-12,724667,California,1,3,4
146611,2016-09-16,656851,Texas,2,2,4
156900,2016-11-17,702958,Virginia,4,0,4
214329,2017-10-19,963219,Colorado,3,1,4
159436,2016-12-01,716001,California,1,3,4
160770,2016-12-09,722452,California,0,4,4
214540,2017-10-21,965251,Pennsylvania,0,4,4
146718,2016-09-16,656991,California,2,2,4
213735,2017-10-15,960036,Texas,2,2,4
158919,2016-11-28,713445,California,0,4,4
161891,2016-12-16,727555,Illinois,0,4,4
158811,2016-11-28,712796,Texas,1,3,4
223559,2017-12-16,1008827,Michigan,0,4,4
145850,2016-09-11,652962,Alabama,1,3,4
223171,2017-12-13,1007054,Ohio,1,3,4
161930,2016-12-16,727544,Illinois,2,2,4
145691,2016-09-10,652175,Florida,1,3,4
215661,2017-10-27,974411,California,0,4,4
10028,2014-03-21,117399,North Carolina,0,4,4
147044,2016-09-18,657854,Pennsylvania,0,4,4
153777,2016-10-29,688210,California,0,4,4
221865,2017-12-04,1001566,Pennsylvania,2,2,4
149140,2016-10-01,668279,Illinois,4,0,4
153436,2016-10-27,686312,Georgia,4,0,4
153584,2016-10-28,687375,Florida,0,4,4
148994,2016-10-01,668352,California,0,4,4
218319,2017-11-12,986816,Georgia,2,2,4
148967,2016-09-30,666524,Minnesota,3,1,4
10282,2014-03-23,117818,Texas,1,3,4
153677,2016-10-29,687940,Ohio,1,3,4
148786,2016-09-29,665995,California,1,3,4
148627,2016-09-28,664971,South Carolina,2,2,4
149166,2016-10-01,667099,South Carolina,4,0,4
218299,2017-11-12,986190,North Carolina,3,1,4
148607,2016-09-28,666870,California,0,4,4
153899,2016-10-30,688979,Ohio,0,4,4
218049,2017-11-11,985582,Texas,1,3,4
217973,2017-11-10,985057,Arizona,4,0,4
153934,2016-10-30,688788,Florida,0,4,4
10335,2014-03-23,117831,Tennessee,1,3,4
153986,2016-10-30,688841,New York,0,4,4
148310,2016-09-26,663789,Texas,0,4,4
154098,2016-10-31,689518,Louisiana,0,4,4
153069,2016-10-25,685379,Ohio,1,3,4
153020,2016-10-25,684711,Ohio,1,3,4
217870,2017-11-09,984455,Pennsylvania,0,4,4
151758,2016-10-17,678214,California,0,4,4
151072,2016-10-14,676278,Texas,2,2,4
10043,2014-03-21,117642,South Carolina,0,4,4
220081,2017-11-24,994436,Pennsylvania,3,1,4
2318,2014-01-15,96942,South Carolina,4,0,4
10104,2014-03-21,117136,Ohio,1,3,4
150381,2016-10-09,672217,California,1,3,4
10126,2014-03-22,118123,Florida,0,4,4
150152,2016-10-08,671717,New York,0,4,4
219214,2017-11-18,991017,Minnesota,0,4,4
221420,2017-12-02,999969,Michigan,0,4,4
219039,2017-11-17,990974,Louisiana,0,4,4
218583,2017-11-14,988824,California,2,2,4
10154,2014-03-22,117680,Missouri,0,4,4
2449,2014-01-16,97452,California,2,2,4
2191,2014-01-14,96792,California,0,4,4
149444,2016-10-03,668407,Minnesota,0,4,4
151790,2016-10-18,679290,California,0,4,4
151864,2016-10-18,679589,Alabama,1,3,4
221599,2017-12-03,1000406,New Jersey,1,3,4
221636,2017-12-03,1000491,Missouri,0,4,4
152448,2016-10-21,681946,Texas,0,4,4
221697,2017-12-03,1000479,Tennessee,1,3,4
217972,2017-11-10,984822,Ohio,0,4,4
148250,2016-09-26,663624,North Carolina,0,4,4
215865,2017-10-28,975817,Ohio,0,4,4
216433,2017-10-31,977366,Indiana,1,3,4
155996,2016-11-11,698255,Idaho,2,2,4
9458,2014-03-16,125855,Georgia,0,4,4
216845,2017-11-03,980258,California,0,4,4
9449,2014-03-16,115879,South Carolina,0,4,4
216817,2017-11-03,980004,New York,0,4,4
216804,2017-11-03,979651,Minnesota,0,4,4
156113,2016-11-12,698942,Missouri,1,3,4
156169,2016-11-12,700363,Missouri,1,3,4
151039,2016-10-13,675993,Illinois,0,4,4
147810,2016-09-23,662035,Tennessee,1,3,4
216103,2017-10-29,975600,Texas,1,3,4
9477,2014-03-16,117591,Texas,3,1,4
147747,2016-09-23,666682,Texas,1,3,4
10441,2014-03-24,118721,North Carolina,3,1,4
147252,2016-09-19,658936,Mississippi,1,3,4
147107,2016-09-18,657863,Virginia,1,3,4
222564,2017-12-09,1004454,Massachusetts,0,4,4
147051,2016-09-18,657843,Ohio,0,4,4
156286,2016-11-13,699332,Texas,0,4,4
215915,2017-10-28,974704,Virginia,1,3,4
156307,2016-11-13,699316,Florida,0,4,4
9379,2014-03-16,115340,North Carolina,0,4,4
155954,2016-11-11,699863,Texas,0,4,4
155841,2016-11-10,697313,Pennsylvania,3,1,4
217841,2017-11-09,1014364,Utah,4,0,4
9552,2014-03-17,118881,New York,0,4,4
217820,2017-11-09,984663,Texas,0,4,4
154460,2016-11-02,691690,Florida,2,2,4
154646,2016-11-03,692315,New Jersey,2,2,4
154687,2016-11-03,692020,Illinois,2,2,4
154820,2016-11-04,693307,Pennsylvania,0,4,4
2606,2014-01-17,97930,California,2,2,4
2650,2014-01-17,97226,Florida,3,1,4
155059,2016-11-05,693624,Florida,1,3,4
155086,2016-11-05,693438,Texas,0,4,4
222090,2017-12-06,1002514,Illinois,0,4,4
155468,2016-11-08,695910,California,2,2,4
155794,2016-11-10,698629,Texas,4,0,4
217124,2017-11-04,980060,California,1,3,4
148177,2016-09-25,662548,Illinois,1,3,4
222499,2017-12-09,1004396,North Carolina,3,1,4
10360,2014-03-23,172722,California,1,3,4
216972,2017-11-04,980269,Texas,0,4,4
155610,2016-11-09,697377,Illinois,1,3,4
155674,2016-11-09,696352,Tennessee,0,4,4
216967,2017-11-04,980192,Ohio,0,4,4
216966,2017-11-04,980170,California,1,3,4
155732,2016-11-10,698383,Texas,1,3,4
192128,2017-06-10,865186,Tennessee,0,4,4
210526,2017-09-26,942830,Maryland,2,2,4
163350,2016-12-25,735947,Alabama,0,4,4
182099,2017-04-15,821651,Illinois,0,4,4
198882,2017-07-18,893726,Wisconsin,0,4,4
6816,2014-02-20,108691,Indiana,4,0,4
180885,2017-04-09,815246,Indiana,1,3,4
180943,2017-04-09,815227,Texas,1,3,4
181040,2017-04-10,815812,California,3,1,4
181652,2017-04-13,818932,Georgia,1,3,4
198431,2017-07-15,891291,Pennsylvania,1,3,4
198354,2017-07-15,891092,Illinois,0,4,4
198060,2017-07-13,889758,South Carolina,4,0,4
181934,2017-04-15,820565,Indiana,0,4,4
181980,2017-04-15,821640,Illinois,0,4,4
197834,2017-07-12,888382,Alabama,4,0,4
182025,2017-04-15,822750,California,0,4,4
197828,2017-07-12,888730,California,0,4,4
182130,2017-04-15,821055,Pennsylvania,0,4,4
8586,2014-03-09,113231,Wisconsin,0,4,4
182136,2017-04-16,821667,California,0,4,4
182256,2017-04-16,821723,North Carolina,0,4,4
182260,2017-04-16,822223,Illinois,0,4,4
197227,2017-07-08,886002,Illinois,0,4,4
182961,2017-04-20,824924,Washington,1,3,4
183025,2017-04-20,825111,Kentucky,0,4,4
197019,2017-07-07,890129,Pennsylvania,4,0,4
183069,2017-04-21,825694,Florida,2,2,4
196754,2017-07-06,884764,Mississippi,0,4,4
196709,2017-07-05,883282,Illinois,2,2,4
184017,2017-04-26,829647,Georgia,1,3,4
196694,2017-07-05,883052,Georgia,0,4,4
184053,2017-04-26,829073,Florida,0,4,4
184322,2017-04-27,830984,New Jersey,1,3,4
198897,2017-07-18,893712,New Jersey,1,3,4
198916,2017-07-18,893752,Arizona,0,4,4
180521,2017-04-07,813877,North Carolina,3,1,4
199034,2017-07-19,894504,California,1,3,4
202255,2017-08-06,907546,New York,0,4,4
202034,2017-08-05,907247,New Jersey,0,4,4
202015,2017-08-05,907611,South Carolina,1,3,4
177969,2017-03-24,801786,Pennsylvania,0,4,4
178051,2017-03-25,802837,Ohio,2,2,4
178059,2017-03-25,803460,Michigan,1,3,4
178070,2017-03-25,802488,Pennsylvania,1,3,4
202001,2017-08-05,906568,Florida,1,3,4
201774,2017-08-03,905132,Florida,0,4,4
178201,2017-03-26,803689,Ohio,2,2,4
7093,2014-02-22,109142,California,0,4,4
201623,2017-08-03,906126,District of Columbia,1,3,4
201524,2017-08-02,904907,Indiana,2,2,4
201464,2017-08-02,904329,Maryland,0,4,4
7068,2014-02-22,109255,California,0,4,4
201259,2017-08-01,903853,Illinois,0,4,4
7012,2014-02-22,109050,Tennessee,0,4,4
179012,2017-03-30,807691,Ohio,4,0,4
179039,2017-03-30,807618,Illinois,4,0,4
201200,2017-07-31,903848,Colorado,2,2,4
201091,2017-07-31,903090,Illinois,0,4,4
201077,2017-07-30,902187,Texas,1,3,4
200698,2017-07-28,900963,Delaware,0,4,4
200116,2017-07-25,898448,Florida,1,3,4
199768,2017-07-23,896444,Illinois,1,3,4
199699,2017-07-23,896889,Louisiana,0,4,4
179754,2017-04-03,810756,Pennsylvania,3,1,4
180355,2017-04-06,813028,Louisiana,1,3,4
199122,2017-07-19,894157,Ohio,2,2,4
184408,2017-04-28,831201,Pennsylvania,0,4,4
184493,2017-04-28,830604,Connecticut,0,4,4
184527,2017-04-29,835459,California,1,3,4
186896,2017-05-12,841800,Ohio,4,0,4
193532,2017-06-18,869877,Illinois,0,4,4
193513,2017-06-18,870222,District of Columbia,0,4,4
187320,2017-05-14,843590,Texas,0,4,4
187651,2017-05-16,845364,South Carolina,3,1,4
193338,2017-06-17,869838,Illinois,0,4,4
188459,2017-05-21,849215,Arizona,0,4,4
6043,2014-02-12,106243,California,1,3,4
188604,2017-05-21,848680,Iowa,1,3,4
193333,2017-06-17,870529,New York,0,4,4
5493,2014-02-07,104618,Ohio,4,0,4
5986,2014-02-12,106481,California,1,3,4
193060,2017-06-15,868042,Virginia,1,3,4
189369,2017-05-26,852676,Florida,0,4,4
189617,2017-05-27,853032,New York,0,4,4
192863,2017-06-14,868147,Ohio,0,4,4
192778,2017-06-13,866412,Maryland,0,4,4
190156,2017-05-29,855113,Kentucky,1,3,4
190325,2017-05-30,855764,Ohio,1,3,4
190569,2017-06-01,857443,Missouri,3,1,4
192722,2017-06-13,866448,Maryland,2,2,4
190843,2017-06-02,858877,California,1,3,4
190987,2017-06-03,858810,Missouri,2,2,4
191034,2017-06-03,859253,Louisiana,0,4,4
191239,2017-06-04,860792,Indiana,4,0,4
192657,2017-06-13,869474,Missouri,0,4,4
5571,2014-02-08,104987,Oklahoma,0,4,4
191500,2017-06-06,860715,California,3,1,4
192303,2017-06-11,865371,Texas,0,4,4
192268,2017-06-11,864852,Tennessee,0,4,4
144819,2016-09-05,647905,New York,2,2,4
186548,2017-05-10,840339,New Jersey,1,3,4
184566,2017-04-29,832063,Virginia,0,4,4
5436,2014-02-06,105010,Louisiana,0,4,4
184605,2017-04-29,831667,Maryland,1,3,4
5070,2014-02-03,140117,Texas,4,0,4
196395,2017-07-04,883489,North Carolina,1,3,4
196370,2017-07-04,882665,Florida,0,4,4
184663,2017-04-29,834788,California,0,4,4
196132,2017-07-03,882422,Alabama,3,1,4
196119,2017-07-03,881921,Michigan,1,3,4
196025,2017-07-02,880738,South Carolina,0,4,4
195912,2017-07-02,881700,New Jersey,0,4,4
195872,2017-07-01,880813,California,0,4,4
195791,2017-07-01,880861,North Carolina,0,4,4
195769,2017-07-01,883656,Illinois,0,4,4
195767,2017-07-01,880808,New Jersey,2,2,4
5227,2014-02-05,104218,Illinois,1,3,4
6405,2014-02-16,107362,Michigan,0,4,4
195380,2017-06-28,878189,Ohio,1,3,4
195198,2017-06-28,878678,Florida,1,3,4
185182,2017-05-02,834832,Florida,1,3,4
5279,2014-02-05,104105,Florida,1,3,4
194851,2017-06-25,876010,District of Columbia,0,4,4
185500,2017-05-04,835961,Michigan,1,3,4
194831,2017-06-25,875886,Missouri,1,3,4
5285,2014-02-05,196110,Florida,2,2,4
194609,2017-06-24,876076,New Jersey,0,4,4
194595,2017-06-24,874807,California,2,2,4
186299,2017-05-09,839846,Kansas,3,1,4
194571,2017-06-24,874884,North Carolina,0,4,4
186317,2017-05-09,839228,Texas,1,3,4
194029,2017-06-21,873599,Alabama,0,4,4
177731,2017-03-23,801455,Maryland,3,1,4
203194,2017-08-12,912093,Missouri,1,3,4
203464,2017-08-13,912322,California,0,4,4
167021,2017-01-15,752249,Colorado,3,1,4
191824,2017-06-08,862587,Pennsylvania,4,0,4
210461,2017-09-26,942628,Pennsylvania,1,3,4
210455,2017-09-26,942522,Tennessee,0,4,4
210267,2017-09-24,940644,New York,0,4,4
167923,2017-01-20,756015,California,0,4,4
210236,2017-09-24,941257,New Jersey,1,3,4
210144,2017-09-24,941144,Maryland,0,4,4
168086,2017-01-21,756504,Tennessee,2,2,4
210073,2017-09-23,940199,Connecticut,0,4,4
168204,2017-01-22,757001,Georgia,3,1,4
168317,2017-01-22,757032,Illinois,0,4,4
168322,2017-01-22,757153,Texas,1,3,4
210070,2017-09-23,940142,Connecticut,2,2,4
168908,2017-01-27,1025158,Washington,4,0,4
208987,2017-09-17,936028,Michigan,1,3,4
168973,2017-01-27,763206,Texas,3,1,4
169287,2017-01-29,762706,Arizona,1,3,4
208606,2017-09-15,933957,Illinois,4,0,4
169363,2017-01-29,762865,Maryland,3,1,4
208386,2017-09-13,932181,Washington,1,3,4
208370,2017-09-13,932906,Pennsylvania,0,4,4
208347,2017-09-13,932619,Pennsylvania,0,4,4
3716,2014-01-25,100379,Maryland,3,1,4
169463,2017-01-30,764020,Minnesota,0,4,4
169617,2017-01-31,765559,Tennessee,0,4,4
169631,2017-01-31,765153,District of Columbia,0,4,4
170363,2017-02-05,768513,Florida,3,1,4
7927,2014-03-02,111377,Tennessee,0,4,4
170541,2017-02-06,768243,Mississippi,4,0,4
167122,2017-01-16,752756,Texas,0,4,4
210859,2017-09-28,944448,Louisiana,1,3,4
170606,2017-02-06,768916,Pennsylvania,2,2,4
166991,2017-01-15,751064,Illinois,1,3,4
212511,2017-10-08,954792,Missouri,0,4,4
164241,2016-12-30,737991,Alabama,2,2,4
164246,2016-12-30,738576,Connecticut,2,2,4
212375,2017-10-07,954428,Arizona,0,4,4
164275,2016-12-31,738749,Texas,1,3,4
8567,2014-03-09,113156,Ohio,3,1,4
164408,2016-12-31,740447,Georgia,2,2,4
212360,2017-10-07,954458,Texas,0,4,4
164539,2017-01-01,739451,Texas,1,3,4
164541,2017-01-01,740442,South Carolina,4,0,4
8519,2014-03-08,113255,California,1,3,4
211944,2017-10-05,952720,Arizona,4,0,4
8506,2014-03-08,113102,New Jersey,1,3,4
211903,2017-10-04,952917,California,0,4,4
165158,2017-01-03,744381,Oregon,4,0,4
165189,2017-01-03,742001,Texas,0,4,4
165208,2017-01-04,742542,California,3,1,4
165492,2017-01-06,744799,California,2,2,4
211593,2017-10-03,952220,Florida,0,4,4
211470,2017-10-02,950362,Florida,3,1,4
165727,2017-01-07,745236,Michigan,1,3,4
3316,2014-01-21,98844,Georgia,1,3,4
165849,2017-01-08,745687,Kentucky,3,1,4
166204,2017-01-10,748479,Colorado,4,0,4
166316,2017-01-11,748348,Illinois,1,3,4
166373,2017-01-11,748152,New Jersey,1,3,4
166437,2017-01-12,749769,California,2,2,4
211126,2017-09-30,946138,Tennessee,1,3,4
166674,2017-01-13,750232,Kentucky,3,1,4
207929,2017-09-10,930266,Louisiana,1,3,4
170672,2017-02-07,772743,Oklahoma,4,0,4
203487,2017-08-13,912615,Pennsylvania,1,3,4
205098,2017-08-23,919715,California,4,0,4
204995,2017-08-22,918204,Illinois,0,4,4
204823,2017-08-21,917820,North Carolina,4,0,4
174657,2017-03-03,786876,Pennsylvania,0,4,4
204822,2017-08-21,917838,Tennessee,0,4,4
174773,2017-03-04,788382,Texas,2,2,4
7455,2014-02-25,110133,Florida,0,4,4
204768,2017-08-21,918767,Kansas,0,4,4
204754,2017-08-21,917793,New Jersey,0,4,4
4101,2014-01-27,101301,North Carolina,0,4,4
204705,2017-08-21,917713,Maryland,1,3,4
174880,2017-03-04,787801,California,0,4,4
174974,2017-03-05,789126,California,4,0,4
175014,2017-03-05,788194,Rhode Island,0,4,4
175063,2017-03-05,789424,Georgia,0,4,4
175313,2017-03-07,789798,Illinois,0,4,4
175475,2017-03-08,790648,Minnesota,0,4,4
204695,2017-08-21,918061,New Jersey,1,3,4
204617,2017-08-20,916808,New York,0,4,4
175741,2017-03-10,791884,Illinois,3,1,4
175749,2017-03-10,791274,Louisiana,3,1,4
175793,2017-03-10,791298,Illinois,2,2,4
176210,2017-03-13,793991,Maryland,1,3,4
176352,2017-03-15,794468,Louisiana,3,1,4
176396,2017-03-15,795086,Texas,3,1,4
204339,2017-08-19,916652,Texas,0,4,4
204004,2017-08-16,914819,New York,0,4,4
203950,2017-08-16,914768,Missouri,1,3,4
203565,2017-08-14,913924,California,2,2,4
203490,2017-08-13,912375,Virginia,0,4,4
174104,2017-02-27,783963,Virginia,0,4,4
7539,2014-02-26,110365,Illinois,4,0,4
170763,2017-02-07,769511,South Carolina,0,4,4
205248,2017-08-24,920513,Missouri,4,0,4
207738,2017-09-09,931139,Alabama,0,4,4
207451,2017-09-07,929272,California,0,4,4
171024,2017-02-09,771826,Mississippi,4,0,4
3816,2014-01-25,100568,Florida,0,4,4
171444,2017-02-11,772989,Tennessee,0,4,4
171491,2017-02-11,772753,Illinois,1,3,4
171532,2017-02-12,773162,New York,1,3,4
207301,2017-09-06,928380,Illinois,0,4,4
7751,2014-03-01,111109,Michigan,0,4,4
172022,2017-02-15,775903,California,0,4,4
207010,2017-09-04,927277,Illinois,0,4,4
172429,2017-02-17,776988,New York,0,4,4
206883,2017-09-03,926041,Florida,0,4,4
172622,2017-02-18,777876,Pennsylvania,0,4,4
172635,2017-02-18,777410,Indiana,1,3,4
172764,2017-02-19,778182,Virginia,1,3,4
172766,2017-02-19,778961,Idaho,4,0,4
206819,2017-09-03,926346,Kansas,1,3,4
206733,2017-09-02,925809,Kentucky,0,4,4
172873,2017-02-19,777887,Wisconsin,0,4,4
206676,2017-09-02,925436,Illinois,1,3,4
173017,2017-02-20,778538,California,2,2,4
206245,2017-08-30,923533,California,2,2,4
173118,2017-02-21,779582,Mississippi,4,0,4
173179,2017-02-21,780036,Ohio,0,4,4
173367,2017-02-22,780792,New York,0,4,4
173498,2017-02-23,781439,Kansas,4,0,4
205786,2017-08-27,921653,Indiana,1,3,4
205442,2017-08-25,921289,Florida,0,4,4
0,2013-01-01,461105,Pennsylvania,0,4,4
120590,2016-04-10,537825,Wisconsin,1,3,4
144747,2016-09-04,648155,Iowa,2,2,4
67036,2015-04-25,329463,New Jersey,0,4,4
19530,2014-05-31,153532,California,1,3,4
68896,2015-05-07,335903,Ohio,0,4,4
68882,2015-05-07,336622,Michigan,0,4,4
68520,2015-05-04,334681,New York,1,3,4
68293,2015-05-03,334047,New York,0,4,4
68262,2015-05-03,334033,Indiana,0,4,4
19672,2014-06-01,141792,California,0,4,4
67462,2015-04-27,330750,Arizona,2,2,4
66568,2015-04-20,326597,Georgia,3,1,4
63877,2015-04-03,317463,Louisiana,0,4,4
66433,2015-04-19,325862,Virginia,0,4,4
66244,2015-04-18,325166,North Carolina,1,3,4
66243,2015-04-18,325207,North Carolina,0,4,4
66115,2015-04-18,325618,New Jersey,1,3,4
66080,2015-04-17,324627,New York,1,3,4
64489,2015-04-07,319808,Georgia,1,3,4
64235,2015-04-05,318531,Michigan,0,4,4
64177,2015-04-05,318125,Pennsylvania,1,3,4
69408,2015-05-10,338034,New Jersey,0,4,4
69453,2015-05-10,337767,New Jersey,1,3,4
69801,2015-05-12,339729,Missouri,0,4,4
69821,2015-05-13,339875,Louisiana,1,3,4
72927,2015-05-31,350021,Maryland,1,3,4
72832,2015-05-31,350163,Ohio,3,1,4
72680,2015-05-30,349289,California,0,4,4
72509,2015-05-29,349543,South Carolina,0,4,4
72365,2015-05-28,348606,Nebraska,0,4,4
72356,2015-05-28,348673,Pennsylvania,1,3,4
72123,2015-05-26,346725,Louisiana,2,2,4
71697,2015-05-24,346179,Missouri,0,4,4
71685,2015-05-24,345963,Nevada,0,4,4
71587,2015-05-24,346320,Alabama,1,3,4
71436,2015-05-23,346202,California,2,2,4
19303,2014-05-30,140640,Indiana,3,1,4
70963,2015-05-20,344302,Maryland,1,3,4
70787,2015-05-18,343106,Missouri,0,4,4
19391,2014-05-30,141324,Virginia,3,1,4
70364,2015-05-16,341162,New York,0,4,4
69885,2015-05-13,340448,Alaska,4,0,4
64079,2015-04-04,318813,Mississippi,3,1,4
63817,2015-04-03,317165,Florida,0,4,4
55663,2015-01-28,285549,Georgia,1,3,4
58390,2015-02-22,296327,South Carolina,0,4,4
59924,2015-03-07,491864,Missouri,0,4,4
20542,2014-06-07,143979,Michigan,1,3,4
59463,2015-03-03,301026,Nevada,4,0,4
59266,2015-03-01,299893,New Jersey,2,2,4
59203,2015-03-01,300660,Florida,0,4,4
59029,2015-02-28,299190,Maryland,1,3,4
58762,2015-02-25,297681,Texas,3,1,4
58580,2015-02-23,588835,Florida,0,4,4
58182,2015-02-20,295871,California,0,4,4
20080,2014-06-04,142822,Illinois,1,3,4
57861,2015-02-17,295502,Arkansas,1,3,4
20732,2014-06-08,144635,District of Columbia,0,4,4
57394,2015-02-12,292677,South Dakota,2,2,4
57200,2015-02-11,293377,Kentucky,4,0,4
56984,2015-02-09,290626,Florida,3,1,4
20816,2014-06-09,144470,Illinois,3,1,4
56416,2015-02-04,288421,North Carolina,4,0,4
55970,2015-01-31,286810,Georgia,4,0,4
59976,2015-03-07,302368,Tennessee,0,4,4
60088,2015-03-08,302786,South Carolina,1,3,4
20470,2014-06-06,143816,Illinois,0,4,4
60183,2015-03-09,303659,Illinois,1,3,4
63596,2015-04-01,316989,Oklahoma,4,0,4
62581,2015-03-26,313304,Texas,0,4,4
62324,2015-03-24,312119,Indiana,4,0,4
62028,2015-03-22,311535,Alaska,4,0,4
61950,2015-03-21,310573,Florida,0,4,4
61803,2015-03-20,310356,Oklahoma,0,4,4
61667,2015-03-19,309835,Arizona,2,2,4
61532,2015-03-18,308839,New Jersey,1,3,4
61336,2015-03-17,352709,Texas,1,3,4
61122,2015-03-16,307998,North Carolina,0,4,4
61057,2015-03-15,307512,California,0,4,4
61027,2015-03-15,308861,Alabama,3,1,4
60956,2015-03-14,308201,California,0,4,4
60746,2015-03-13,307901,Texas,0,4,4
20413,2014-06-06,143736,South Carolina,0,4,4
60516,2015-03-11,305914,Illinois,0,4,4
60397,2015-03-11,305587,South Carolina,0,4,4
73344,2015-06-03,351936,New York,3,1,4
73652,2015-06-05,352779,Louisiana,1,3,4
74052,2015-06-08,359243,Florida,0,4,4
80414,2015-07-18,377423,Louisiana,2,2,4
81671,2015-07-26,382170,Louisiana,0,4,4
81651,2015-07-25,381433,Virginia,0,4,4
80949,2015-07-21,378452,Florida,1,3,4
80676,2015-07-20,377824,Louisiana,0,4,4
80513,2015-07-19,377189,Virginia,0,4,4
80495,2015-07-19,377181,North Carolina,0,4,4
80442,2015-07-18,378102,California,0,4,4
18238,2014-05-23,138436,Texas,1,3,4
80296,2015-07-17,376203,Ohio,0,4,4
74310,2015-06-09,355267,Missouri,1,3,4
18288,2014-05-23,138370,California,2,2,4
79960,2015-07-15,374965,Michigan,0,4,4
79902,2015-07-15,375322,Maryland,1,3,4
79691,2015-07-14,374292,Missouri,0,4,4
79526,2015-07-13,373993,California,0,4,4
79462,2015-07-12,373063,New Jersey,0,4,4
79410,2015-07-12,373138,Louisiana,3,1,4
78658,2015-07-07,370187,Ohio,1,3,4
82041,2015-07-28,384743,Illinois,2,2,4
18042,2014-05-21,142123,Texas,1,3,4
82278,2015-07-30,384662,Pennsylvania,0,4,4
18032,2014-05-21,137081,Indiana,1,3,4
86150,2015-08-22,399564,New Mexico,3,1,4
85805,2015-08-20,398975,Texas,2,2,4
17638,2014-05-18,136185,Georgia,2,2,4
85244,2015-08-16,395757,Illinois,0,4,4
17699,2014-05-19,136669,Indiana,3,1,4
84983,2015-08-15,395549,South Carolina,1,3,4
84977,2015-08-15,395694,California,0,4,4
84969,2015-08-15,395837,Pennsylvania,1,3,4
84210,2015-08-10,392131,California,0,4,4
84127,2015-08-09,391219,Michigan,1,3,4
84125,2015-08-09,391014,Missouri,0,4,4
84110,2015-08-09,391263,Mississippi,1,3,4
83687,2015-08-07,390050,Vermont,4,0,4
83618,2015-08-06,389057,South Carolina,0,4,4
82915,2015-08-02,401742,Illinois,0,4,4
82813,2015-08-01,386937,Florida,0,4,4
82723,2015-08-01,385525,Wisconsin,0,4,4
78639,2015-07-07,370474,Maryland,3,1,4
18432,2014-05-24,138645,South Carolina,3,1,4
78362,2015-07-05,369120,South Carolina,4,0,4
76370,2015-06-23,363006,Illinois,1,3,4
76100,2015-06-21,366949,Pennsylvania,0,4,4
76085,2015-06-21,362259,Utah,4,0,4
76016,2015-06-20,360895,North Carolina,0,4,4
75875,2015-06-19,361014,Rhode Island,0,4,4
18804,2014-05-26,139689,California,4,0,4
75341,2015-06-16,359215,Florida,0,4,4
75217,2015-06-15,358117,New York,0,4,4
75117,2015-06-14,357667,Oklahoma,0,4,4
75054,2015-06-14,357611,Missouri,0,4,4
75053,2015-06-14,357597,New Jersey,1,3,4
75031,2015-06-14,357999,Texas,0,4,4
74968,2015-06-13,357590,Oklahoma,0,4,4
74858,2015-06-13,357770,Georgia,1,3,4
74810,2015-06-12,357220,Florida,0,4,4
74582,2015-06-11,355883,Texas,1,3,4
74540,2015-06-10,355503,Ohio,1,3,4
74422,2015-06-10,355644,California,1,3,4
76320,2015-06-22,361841,North Carolina,1,3,4
18704,2014-05-26,139335,California,0,4,4
78356,2015-07-05,369196,New Jersey,1,3,4
76397,2015-06-23,363088,Louisiana,3,1,4
18473,2014-05-24,138567,Michigan,0,4,4
78193,2015-07-05,368960,Illinois,0,4,4
78188,2015-07-04,369127,Texas,0,4,4
78107,2015-07-04,369410,Kentucky,0,4,4
78062,2015-07-04,368995,New York,0,4,4
78020,2015-07-04,368867,District of Columbia,1,3,4
77940,2015-07-03,368006,Pennsylvania,2,2,4
77778,2015-07-02,367780,Indiana,1,3,4
18579,2014-05-25,138755,North Carolina,1,3,4
18601,2014-05-25,139281,Ohio,1,3,4
77233,2015-06-29,366046,Florida,0,4,4
77054,2015-06-27,364872,Massachusetts,1,3,4
76979,2015-06-27,364715,Florida,4,0,4
76954,2015-06-27,364705,Connecticut,1,3,4
76931,2015-06-27,364789,Michigan,0,4,4
76883,2015-06-26,364210,Louisiana,0,4,4
76543,2015-06-24,363418,New York,0,4,4
55850,2015-01-30,286706,North Carolina,0,4,4
55399,2015-01-26,285123,California,1,3,4
10758,2014-03-27,120011,California,0,4,4
32146,2014-08-17,175839,Nevada,0,4,4
33540,2014-08-25,181098,Illinois,0,4,4
33374,2014-08-24,180018,Illinois,1,3,4
33267,2014-08-24,180580,Georgia,1,3,4
33005,2014-08-22,179057,South Carolina,1,3,4
23303,2014-06-26,157018,Michigan,2,2,4
32253,2014-08-18,178006,Louisiana,0,4,4
32202,2014-08-18,176571,Rhode Island,1,3,4
32157,2014-08-17,186611,North Carolina,1,3,4
32133,2014-08-17,177770,California,1,3,4
31299,2014-08-13,174544,Tennessee,0,4,4
32056,2014-08-17,175911,New York,0,4,4
32019,2014-08-17,175698,Illinois,0,4,4
32004,2014-08-17,175943,Massachusetts,0,4,4
23346,2014-06-26,151570,Tennessee,2,2,4
31913,2014-08-16,175779,New Jersey,1,3,4
31765,2014-08-15,175217,Tennessee,2,2,4
31611,2014-08-14,175030,Illinois,1,3,4
31532,2014-08-14,174560,Tennessee,1,3,4
33693,2014-08-26,181121,Oklahoma,4,0,4
33740,2014-08-27,181947,Michigan,1,3,4
34058,2014-08-29,182974,Florida,3,1,4
34387,2014-08-31,184564,Alabama,2,2,4
39141,2014-09-28,197416,Pennsylvania,0,4,4
22760,2014-06-22,154136,California,1,3,4
38050,2014-09-21,194127,Pennsylvania,2,2,4
38038,2014-09-21,194945,Ohio,0,4,4
37930,2014-09-20,193960,Mississippi,2,2,4
37715,2014-09-19,193570,New York,0,4,4
36900,2014-09-14,190874,Texas,3,1,4
36844,2014-09-14,191269,Virginia,1,3,4
35830,2014-09-08,188222,South Carolina,2,2,4
35590,2014-09-07,187757,California,0,4,4
35430,2014-09-06,188332,Florida,0,4,4
35109,2014-09-04,187921,Florida,0,4,4
34867,2014-09-03,185440,New York,1,3,4
34705,2014-09-02,185128,Oklahoma,4,0,4
23098,2014-06-24,150610,Texas,0,4,4
34534,2014-09-01,184284,North Carolina,2,2,4
34497,2014-08-31,183390,Illinois,4,0,4
31342,2014-08-13,175767,Louisiana,0,4,4
31232,2014-08-12,173369,New York,1,3,4
54626,2015-01-20,281663,Tennessee,1,3,4
25739,2014-07-11,157580,Illinois,1,3,4
27365,2014-07-21,162008,Tennessee,0,4,4
27218,2014-07-20,161063,Nevada,1,3,4
27210,2014-07-20,160998,Illinois,1,3,4
27082,2014-07-19,160488,Illinois,0,4,4
23906,2014-06-30,153423,Texas,2,2,4
23965,2014-06-30,153275,Kentucky,1,3,4
25988,2014-07-13,159291,District of Columbia,0,4,4
25937,2014-07-12,157642,Ohio,0,4,4
25086,2014-07-07,155523,Kentucky,0,4,4
30965,2014-08-11,172763,Texas,1,3,4
25067,2014-07-07,162305,Kentucky,0,4,4
24956,2014-07-06,162999,Texas,0,4,4
24950,2014-07-06,155755,New York,0,4,4
24913,2014-07-06,156125,Florida,2,2,4
24876,2014-07-06,155412,Missouri,0,4,4
24845,2014-07-06,156008,Louisiana,2,2,4
24793,2014-07-05,154810,Texas,0,4,4
24640,2014-07-05,154762,Michigan,0,4,4
23841,2014-06-29,153648,Missouri,0,4,4
27836,2014-07-23,162687,Pennsylvania,0,4,4
28308,2014-07-26,166970,Arkansas,1,3,4
28491,2014-07-27,165210,Michigan,0,4,4
23480,2014-06-27,157032,Oregon,0,4,4
30667,2014-08-09,172929,Pennsylvania,0,4,4
30585,2014-08-08,173786,District of Columbia,0,4,4
30499,2014-08-08,171823,New Mexico,1,3,4
30494,2014-08-08,171778,Wisconsin,0,4,4
23514,2014-06-27,152722,California,1,3,4
30369,2014-08-07,170949,Kansas,1,3,4
30282,2014-08-06,170009,Illinois,0,4,4
30257,2014-08-06,170704,California,3,1,4
30029,2014-08-05,179365,North Carolina,3,1,4
23591,2014-06-28,153578,New York,0,4,4
29687,2014-08-03,168800,Minnesota,1,3,4
29503,2014-08-02,169239,New Jersey,0,4,4
29488,2014-08-02,168371,Wisconsin,1,3,4
29482,2014-08-02,167872,Texas,3,1,4
29374,2014-08-01,167649,Pennsylvania,1,3,4
28595,2014-07-28,164834,New York,1,3,4
39176,2014-09-28,197318,Indiana,0,4,4
39327,2014-09-29,198527,California,0,4,4
39969,2014-10-03,202070,Mississippi,2,2,4
21558,2014-06-14,146680,Wisconsin,0,4,4
21468,2014-06-13,146062,Tennessee,0,4,4
21472,2014-06-13,147074,North Carolina,1,3,4
50871,2014-12-22,268282,Michigan,1,3,4
50816,2014-12-21,267579,Texas,2,2,4
50810,2014-12-21,266570,Florida,2,2,4
50646,2014-12-20,266407,Illinois,4,0,4
21517,2014-06-14,146272,Illinois,0,4,4
21539,2014-06-14,146267,Illinois,3,1,4
50092,2014-12-16,264901,New Jersey,0,4,4
40009,2014-10-03,213104,Mississippi,2,2,4
50077,2014-12-15,264046,Pennsylvania,1,3,4
50010,2014-12-15,264102,Illinois,0,4,4
49625,2014-12-12,262202,Oregon,0,4,4
21682,2014-06-15,146990,Virginia,4,0,4
48993,2014-12-07,259935,Indiana,0,4,4
48990,2014-12-07,260232,Texas,3,1,4
21700,2014-06-15,146565,Indiana,0,4,4
21742,2014-06-15,146586,Illinois,0,4,4
51078,2014-12-23,267792,Kentucky,1,3,4
51104,2014-12-24,268598,Missouri,1,3,4
51315,2014-12-26,269167,Illinois,1,3,4
51499,2014-12-27,270036,California,0,4,4
53666,2015-01-13,278927,Illinois,2,2,4
53379,2015-01-11,277480,Florida,1,3,4
53370,2015-01-10,276613,Idaho,3,1,4
53361,2015-01-10,276536,Kansas,2,2,4
53213,2015-01-09,275994,Kansas,1,3,4
53187,2015-01-09,276459,California,4,0,4
53136,2015-01-08,275986,Massachusetts,1,3,4
53028,2015-01-07,275064,Tennessee,1,3,4
52869,2015-01-06,274867,Florida,1,3,4
52826,2015-01-06,275007,Georgia,4,0,4
52689,2015-01-04,273397,Texas,3,1,4
21285,2014-06-12,151674,Tennessee,0,4,4
52306,2015-01-01,272531,California,4,0,4
52031,2014-12-31,272104,North Carolina,0,4,4
51820,2014-12-29,271363,Louisiana,0,4,4
51592,2014-12-27,269679,California,1,3,4
21402,2014-06-13,149706,California,3,1,4
48517,2014-12-03,227234,North Carolina,3,1,4
48241,2014-11-30,226388,New York,0,4,4
48033,2014-11-29,226150,New Jersey,1,3,4
42425,2014-10-18,207145,South Carolina,1,3,4
42307,2014-10-18,209134,New York,0,4,4
42245,2014-10-17,206739,Florida,3,1,4
41992,2014-10-16,206303,Michigan,1,3,4
22423,2014-06-20,157013,Maryland,0,4,4
41488,2014-10-13,205298,Georgia,0,4,4
41415,2014-10-12,204477,Georgia,1,3,4
41402,2014-10-12,204310,California,3,1,4
41213,2014-10-11,203789,Illinois,1,3,4
40799,2014-10-08,204254,New York,4,0,4
40736,2014-10-08,202897,Virginia,4,0,4
40730,2014-10-08,202981,Georgia,0,4,4
22567,2014-06-21,149954,District of Columbia,0,4,4
40216,2014-10-05,201630,Florida,3,1,4
40182,2014-10-04,200538,Illinois,1,3,4
40177,2014-10-04,201502,California,0,4,4
40138,2014-10-04,222808,North Carolina,0,4,4
40126,2014-10-04,201648,Tennessee,2,2,4
42386,2014-10-18,207687,New York,0,4,4
42602,2014-10-20,208979,North Carolina,1,3,4
48000,2014-11-28,225830,Tennessee,0,4,4
42832,2014-10-21,208710,Michigan,0,4,4
47480,2014-11-23,224362,Virginia,0,4,4
47339,2014-11-22,223729,Ohio,1,3,4
21895,2014-06-16,147402,Georgia,0,4,4
47227,2014-11-21,223550,Texas,0,4,4
47049,2014-11-20,222932,New Jersey,4,0,4
47031,2014-11-20,222873,Florida,1,3,4
47016,2014-11-19,222792,Illinois,1,3,4
46835,2014-11-18,222393,Nevada,0,4,4
21959,2014-06-17,147912,Illinois,0,4,4
46502,2014-11-15,221577,Florida,1,3,4
46438,2014-11-15,221347,Missouri,4,0,4
46380,2014-11-14,221226,North Carolina,1,3,4
45453,2014-11-08,217441,Virginia,0,4,4
45362,2014-11-07,217401,California,0,4,4
45345,2014-11-07,218054,California,0,4,4
45001,2014-11-05,216533,California,0,4,4
43627,2014-10-26,211348,Kentucky,4,0,4
86164,2015-08-22,399883,Florida,0,4,4
86675,2015-08-25,402108,Louisiana,1,3,4
86796,2015-08-26,402113,Illinois,2,2,4
129288,2016-06-04,572542,Alabama,1,3,4
129980,2016-06-09,575607,Florida,0,4,4
129917,2016-06-08,574850,District of Columbia,0,4,4
129914,2016-06-08,574753,Massachusetts,1,3,4
12679,2014-04-11,124146,Indiana,0,4,4
129502,2016-06-06,573327,California,0,4,4
129478,2016-06-05,575061,Minnesota,0,4,4
129473,2016-06-05,572513,New York,0,4,4
12722,2014-04-11,124695,Texas,1,3,4
129193,2016-06-04,571859,Colorado,3,1,4
127172,2016-05-22,563514,California,1,3,4
128729,2016-05-31,569189,Indiana,0,4,4
128688,2016-05-31,569225,Illinois,0,4,4
128351,2016-05-29,567494,Indiana,0,4,4
128312,2016-05-29,567788,Nevada,0,4,4
128041,2016-05-27,569275,Massachusetts,0,4,4
12899,2014-04-12,125028,Louisiana,1,3,4
127645,2016-05-25,565816,New York,1,3,4
127273,2016-05-22,563829,Louisiana,0,4,4
130374,2016-06-11,578238,Minnesota,0,4,4
130397,2016-06-11,577938,California,1,3,4
130405,2016-06-11,576774,North Carolina,1,3,4
130678,2016-06-13,579517,California,0,4,4
132398,2016-06-25,588505,Illinois,1,3,4
132379,2016-06-25,587983,Illinois,0,4,4
132309,2016-06-25,589470,Virginia,0,4,4
132235,2016-06-24,589046,Kansas,0,4,4
131931,2016-06-22,586058,Illinois,0,4,4
131874,2016-06-22,585821,Washington,3,1,4
131847,2016-06-21,585615,Kentucky,2,2,4
131801,2016-06-21,586044,New Jersey,0,4,4
12439,2014-04-09,124131,Illinois,0,4,4
131374,2016-06-19,583631,Virginia,0,4,4
131334,2016-06-18,583537,Georgia,2,2,4
131235,2016-06-18,583362,Illinois,0,4,4
131185,2016-06-18,583584,Virginia,1,3,4
130799,2016-06-14,580848,Delaware,0,4,4
12549,2014-04-09,123891,Tennessee,3,1,4
130750,2016-06-14,580791,California,1,3,4
130704,2016-06-13,579772,Georgia,3,1,4
127178,2016-05-22,563751,Tennessee,0,4,4
126978,2016-05-21,563630,Georgia,1,3,4
86800,2015-08-26,401893,Virginia,3,1,4
121560,2016-04-17,543102,South Carolina,1,3,4
122630,2016-04-23,546244,Alabama,3,1,4
122623,2016-04-23,546581,Nevada,1,3,4
122606,2016-04-23,546513,Washington,0,4,4
122395,2016-04-21,545501,Maryland,0,4,4
122008,2016-04-19,543457,Texas,4,0,4
121975,2016-04-19,544080,Illinois,1,3,4
121903,2016-04-18,543244,California,1,3,4
121741,2016-04-17,541996,Pennsylvania,3,1,4
121422,2016-04-16,542362,Alabama,0,4,4
126710,2016-05-19,562394,Maryland,0,4,4
224345,2017-12-21,1012704,Louisiana,0,4,4
120589,2016-04-10,537820,California,0,4,4
120387,2016-04-09,537085,New Mexico,0,4,4
120384,2016-04-09,539705,Alabama,0,4,4
120360,2016-04-09,537311,Tennessee,0,4,4
13773,2014-04-19,127407,Oklahoma,1,3,4
120103,2016-04-07,535927,Illinois,0,4,4
119916,2016-04-06,535834,Florida,1,3,4
122635,2016-04-23,546258,New York,0,4,4
122854,2016-04-24,546818,Colorado,0,4,4
122956,2016-04-25,547355,Nevada,1,3,4
123035,2016-04-25,547639,Tennessee,0,4,4
126587,2016-05-18,561912,Indiana,0,4,4
126406,2016-05-17,560782,South Carolina,3,1,4
13113,2014-04-14,156828,District of Columbia,0,4,4
126212,2016-05-15,559194,Indiana,0,4,4
126001,2016-05-14,558796,West Virginia,1,3,4
125895,2016-05-14,558875,Arizona,2,2,4
13180,2014-04-14,125129,New Jersey,2,2,4
125533,2016-05-11,557553,Illinois,4,0,4
125074,2016-05-08,555126,Texas,1,3,4
124654,2016-05-06,555886,Alabama,1,3,4
124495,2016-05-05,553726,Nevada,2,2,4
124454,2016-05-05,554027,Florida,1,3,4
124198,2016-05-03,552393,Florida,4,0,4
123667,2016-04-29,550445,Missouri,0,4,4
123316,2016-04-27,549071,Mississippi,3,1,4
123237,2016-04-27,549507,Louisiana,2,2,4
123037,2016-04-25,547243,Tennessee,0,4,4
132539,2016-06-26,590233,South Carolina,0,4,4
132551,2016-06-26,589081,South Carolina,0,4,4
132604,2016-06-26,589165,Texas,1,3,4
140190,2016-08-10,626960,California,1,3,4
140930,2016-08-14,630007,Virginia,0,4,4
140822,2016-08-13,629663,California,0,4,4
140788,2016-08-13,628623,New York,0,4,4
140705,2016-08-13,628635,Missouri,0,4,4
140647,2016-08-13,628570,Wisconsin,2,2,4
140580,2016-08-12,627519,Texas,1,3,4
140517,2016-08-12,628178,Florida,1,3,4
140326,2016-08-11,627757,Pennsylvania,0,4,4
140164,2016-08-10,626153,Illinois,0,4,4
132647,2016-06-26,588918,Texas,0,4,4
139935,2016-08-08,625315,Texas,1,3,4
139905,2016-08-08,625735,New Mexico,2,2,4
139847,2016-08-08,624513,Ohio,2,2,4
139717,2016-08-07,624156,California,1,3,4
139646,2016-08-07,624046,Mississippi,1,3,4
139644,2016-08-07,623523,Colorado,2,2,4
139579,2016-08-07,623439,Illinois,0,4,4
139305,2016-08-05,624057,Michigan,1,3,4
11197,2014-03-30,120085,South Carolina,1,3,4
141444,2016-08-17,632753,California,0,4,4
141532,2016-08-18,632747,Connecticut,0,4,4
141633,2016-08-18,633204,Missouri,1,3,4
144373,2016-09-03,646995,North Carolina,1,3,4
144371,2016-09-03,646855,Illinois,0,4,4
143770,2016-08-30,643980,North Carolina,0,4,4
143756,2016-08-30,643824,Illinois,0,4,4
143719,2016-08-30,644723,Georgia,0,4,4
143436,2016-08-28,640749,North Carolina,2,2,4
143435,2016-08-28,640689,Missouri,2,2,4
143356,2016-08-28,640677,New York,0,4,4
143294,2016-08-28,640979,Texas,2,2,4
10958,2014-03-28,119668,California,0,4,4
10968,2014-03-28,119900,Louisiana,3,1,4
11043,2014-03-29,120693,South Carolina,1,3,4
142057,2016-08-21,634889,Massachusetts,0,4,4
142020,2016-08-20,642038,North Dakota,0,4,4
142011,2016-08-20,634238,Connecticut,0,4,4
141870,2016-08-20,634075,California,2,2,4
141677,2016-08-18,633193,Oregon,3,1,4
139276,2016-08-05,622500,California,2,2,4
139046,2016-08-04,621232,Tennessee,0,4,4
138910,2016-08-03,620247,Georgia,1,3,4
135468,2016-07-14,603733,California,0,4,4
135280,2016-07-13,602765,Missouri,2,2,4
135272,2016-07-13,602151,Washington,0,4,4
135043,2016-07-11,601512,District of Columbia,0,4,4
134967,2016-07-11,601119,Michigan,0,4,4
134447,2016-07-07,598740,Louisiana,1,3,4
134395,2016-07-07,597366,Louisiana,0,4,4
12086,2014-04-06,123666,Massachusetts,0,4,4
12105,2014-04-06,125863,Oklahoma,0,4,4
134028,2016-07-05,595557,California,0,4,4
133970,2016-07-04,595048,Pennsylvania,0,4,4
133959,2016-07-04,595279,Illinois,0,4,4
133920,2016-07-04,596159,Ohio,0,4,4
133709,2016-07-03,594480,Tennessee,0,4,4
12201,2014-04-07,123008,Louisiana,0,4,4
132975,2016-06-28,591975,California,1,3,4
132953,2016-06-28,591294,Illinois,0,4,4
132765,2016-06-27,589488,Oregon,3,1,4
135418,2016-07-14,603475,Texas,3,1,4
135476,2016-07-14,603738,Ohio,1,3,4
138709,2016-08-02,619708,Florida,0,4,4
11933,2014-04-05,122612,Arizona,1,3,4
138663,2016-08-01,619408,Indiana,0,4,4
138455,2016-07-31,617789,Florida,3,1,4
138261,2016-07-30,617152,Missouri,4,0,4
138250,2016-07-30,616948,Washington,3,1,4
137939,2016-07-28,615328,Maryland,0,4,4
137841,2016-07-28,615024,Illinois,2,2,4
136928,2016-07-23,610756,South Carolina,0,4,4
136902,2016-07-23,613805,New York,0,4,4
136861,2016-07-23,610093,Ohio,2,2,4
136520,2016-07-20,608787,California,0,4,4
136332,2016-07-19,607265,Arkansas,0,4,4
11817,2014-04-04,122329,Michigan,0,4,4
136039,2016-07-17,605475,Texas,1,3,4
135970,2016-07-17,605367,Michigan,0,4,4
135839,2016-07-16,605005,California,0,4,4
11906,2014-04-05,122672,California,0,4,4
135568,2016-07-15,604207,Washington,3,1,4
1,2013-01-01,460726,California,1,3,4
119271,2016-04-01,532950,New Mexico,3,1,4
13880,2014-04-20,127022,Minnesota,1,3,4
16378,2014-05-09,134267,Louisiana,0,4,4
98016,2015-11-07,443652,Colorado,1,3,4
97909,2015-11-06,444406,California,0,4,4
97626,2015-11-04,442231,Maine,4,0,4
97606,2015-11-04,441867,Texas,2,2,4
97195,2015-11-02,440743,South Carolina,4,0,4
96988,2015-10-31,439734,Colorado,4,0,4
16367,2014-05-09,133455,California,4,0,4
96536,2015-10-28,438651,Louisiana,1,3,4
96376,2015-10-27,438188,North Carolina,3,1,4
102083,2015-12-06,460049,Louisiana,1,3,4
96176,2015-10-26,519999,New Jersey,0,4,4
96102,2015-10-25,438516,Kentucky,1,3,4
95947,2015-10-24,436219,South Carolina,0,4,4
16451,2014-05-10,133497,Indiana,1,3,4
16464,2014-05-10,134044,Georgia,1,3,4
95736,2015-10-23,435500,Rhode Island,0,4,4
95652,2015-10-22,435144,Tennessee,1,3,4
94993,2015-10-18,432711,Louisiana,0,4,4
98149,2015-11-08,444168,Michigan,0,4,4
98175,2015-11-08,443821,Iowa,1,3,4
98350,2015-11-09,444458,Indiana,2,2,4
16150,2014-05-07,133202,Florida,4,0,4
15801,2014-05-05,133100,Texas,2,2,4
101506,2015-12-02,457037,Georgia,1,3,4
101153,2015-11-30,457506,Oklahoma,0,4,4
100770,2015-11-27,455684,California,2,2,4
15897,2014-05-05,132651,Tennessee,0,4,4
100604,2015-11-26,453682,Massachusetts,1,3,4
100404,2015-11-24,454788,South Carolina,0,4,4
100194,2015-11-23,452131,Texas,1,3,4
100131,2015-11-22,451338,Washington,0,4,4
100128,2015-11-22,453317,Texas,0,4,4
100106,2015-11-22,451349,Illinois,0,4,4
100101,2015-11-22,452362,South Carolina,1,3,4
100001,2015-11-21,451057,Maryland,1,3,4
99888,2015-11-20,450505,Pennsylvania,1,3,4
99296,2015-11-16,448653,Alabama,3,1,4
99166,2015-11-15,448286,Pennsylvania,0,4,4
98993,2015-11-14,447462,Pennsylvania,0,4,4
94766,2015-10-17,432072,Indiana,0,4,4
94150,2015-10-12,429410,Georgia,0,4,4
16659,2014-05-11,134320,Nevada,1,3,4
89645,2015-09-13,413060,Louisiana,4,0,4
89453,2015-09-12,412996,Louisiana,0,4,4
88974,2015-09-08,411888,Georgia,0,4,4
88973,2015-09-08,409856,Illinois,0,4,4
88884,2015-09-08,410852,Washington,4,0,4
88771,2015-09-07,409601,Colorado,0,4,4
88469,2015-09-05,408256,Missouri,0,4,4
88466,2015-09-05,409101,Nevada,1,3,4
88463,2015-09-05,408276,Florida,0,4,4
88377,2015-09-05,408449,North Carolina,1,3,4
87696,2015-09-01,407854,New Jersey,4,0,4
87289,2015-08-29,405133,Texas,1,3,4
87236,2015-08-29,405114,Georgia,0,4,4
87055,2015-08-28,403069,New York,1,3,4
86974,2015-08-27,403669,California,2,2,4
17476,2014-05-17,136567,California,1,3,4
86833,2015-08-26,402051,Florida,2,2,4
86829,2015-08-26,401884,Minnesota,0,4,4
89489,2015-09-12,412539,Minnesota,1,3,4
17136,2014-05-15,138324,Georgia,1,3,4
16676,2014-05-12,134591,Illinois,0,4,4
89727,2015-09-13,413332,New Mexico,2,2,4
93857,2015-10-10,428247,North Carolina,0,4,4
93722,2015-10-10,429614,Illinois,1,3,4
93655,2015-10-09,427621,Arizona,1,3,4
92616,2015-10-01,423863,Florida,4,0,4
92102,2015-09-28,422887,North Carolina,1,3,4
92087,2015-09-28,422020,Ohio,0,4,4
92027,2015-09-27,421358,Illinois,0,4,4
92026,2015-09-27,420855,Missouri,0,4,4
91644,2015-09-25,426559,Illinois,0,4,4
91351,2015-09-23,418964,Florida,0,4,4
91255,2015-09-23,419826,Georgia,1,3,4
90981,2015-09-21,417615,California,2,2,4
90868,2015-09-20,417284,Pennsylvania,1,3,4
90654,2015-09-19,416812,Indiana,1,3,4
90306,2015-09-17,415687,Michigan,0,4,4
89967,2015-09-15,414580,New Jersey,0,4,4
89803,2015-09-13,413522,Louisiana,4,0,4
15752,2014-05-04,132897,Colorado,0,4,4
102267,2015-12-08,461476,Ohio,1,3,4
119154,2016-03-31,532604,Illinois,0,4,4
113519,2016-02-24,511237,Georgia,0,4,4
115291,2016-03-07,517895,Louisiana,0,4,4
115045,2016-03-06,517114,Georgia,0,4,4
114944,2016-03-05,516758,Kansas,0,4,4
114808,2016-03-04,516341,Ohio,1,3,4
14456,2014-04-24,128896,Texas,1,3,4
114057,2016-02-28,513640,California,1,3,4
113875,2016-02-27,512880,Virginia,2,2,4
113544,2016-02-24,510749,Colorado,2,2,4
113423,2016-02-23,510769,Florida,0,4,4
15718,2014-05-04,131697,Illinois,1,3,4
113117,2016-02-21,508879,Missouri,1,3,4
112974,2016-02-20,508356,Alabama,1,3,4
112906,2016-02-20,508510,Florida,0,4,4
112861,2016-02-20,508341,Florida,1,3,4
112810,2016-02-19,590221,Missouri,4,0,4
112793,2016-02-19,507998,California,1,3,4
112626,2016-02-18,509170,Utah,3,1,4
112391,2016-02-16,507100,California,0,4,4
115930,2016-03-11,520767,Michigan,2,2,4
115991,2016-03-12,521498,Georgia,2,2,4
116007,2016-03-12,521074,California,0,4,4
116116,2016-03-12,521821,Oregon,0,4,4
119101,2016-03-31,532377,Nevada,4,0,4
119041,2016-03-31,532070,Virginia,2,2,4
13918,2014-04-20,130835,Minnesota,1,3,4
13948,2014-04-20,127381,Florida,2,2,4
118433,2016-03-27,530049,Louisiana,0,4,4
118108,2016-03-25,529926,Alabama,2,2,4
118044,2016-03-25,529488,Colorado,0,4,4
118003,2016-03-25,528614,Illinois,0,4,4
117647,2016-03-22,543116,California,0,4,4
117435,2016-03-21,527206,Texas,4,0,4
117423,2016-03-21,526380,Illinois,0,4,4
117304,2016-03-20,525992,Kentucky,4,0,4
117181,2016-03-19,525301,Alabama,2,2,4
116891,2016-03-17,523992,Florida,0,4,4
116448,2016-03-14,522516,Illinois,1,3,4
14224,2014-04-22,173109,California,1,3,4
116238,2016-03-13,522122,Florida,0,4,4
112125,2016-02-14,504879,Texas,1,3,4
112006,2016-02-13,504996,Louisiana,0,4,4
111797,2016-02-12,504390,Minnesota,2,2,4
106927,2016-01-08,481849,District of Columbia,0,4,4
106655,2016-01-06,479613,Florida,3,1,4
105580,2015-12-31,476338,California,4,0,4
105000,2015-12-27,473882,Tennessee,0,4,4
104867,2015-12-26,472268,Pennsylvania,0,4,4
104812,2015-12-25,471860,Alabama,0,4,4
104734,2015-12-25,471867,Florida,0,4,4
104234,2015-12-21,469468,California,0,4,4
104075,2015-12-20,469614,Florida,0,4,4
15586,2014-05-03,132405,Texas,0,4,4
103283,2015-12-15,466469,Oregon,3,1,4
103096,2015-12-13,464945,California,0,4,4
103087,2015-12-13,464665,California,1,3,4
102950,2015-12-12,465117,Illinois,1,3,4
102933,2015-12-12,464002,Georgia,0,4,4
102786,2015-12-11,463642,Maryland,1,3,4
102722,2015-12-11,463734,Pennsylvania,0,4,4
102410,2015-12-09,462108,Florida,2,2,4
106717,2016-01-07,481429,Tennessee,1,3,4
15205,2014-04-30,130933,Illinois,0,4,4
111744,2016-02-11,503757,Georgia,1,3,4
107723,2016-01-13,484571,Georgia,2,2,4
14717,2014-04-26,129196,Illinois,0,4,4
14738,2014-04-26,129788,Georgia,1,3,4
111468,2016-02-09,502749,Michigan,0,4,4
111263,2016-02-07,501349,Illinois,0,4,4
111102,2016-02-06,500629,Florida,0,4,4
111090,2016-02-06,501153,Texas,4,0,4
111037,2016-02-06,501267,California,1,3,4
110706,2016-02-03,499422,District of Columbia,0,4,4
110155,2016-01-31,496862,Louisiana,0,4,4
109998,2016-01-30,495951,Colorado,1,3,4
109854,2016-01-29,496014,Virginia,2,2,4
109041,2016-01-23,491024,Florida,3,1,4
108969,2016-01-23,491312,California,2,2,4
108920,2016-01-23,490968,Mississippi,2,2,4
108757,2016-01-21,489447,Oklahoma,2,2,4
15046,2014-04-29,130323,Illinois,0,4,4
108233,2016-01-17,486728,Virginia,1,3,4
224324,2017-12-20,1011495,Georgia,1,3,4
134100,2016-07-05,595667,Georgia,2,2,4
228,2013-10-27,492427,Texas,0,4,4
71,2013-05-11,486244,New Jersey,0,4,4
225779,2017-12-31,1017422,Illinois,0,4,4
87,2013-05-28,487052,Tennessee,1,3,4
85,2013-05-25,486977,Michigan,1,3,4
183,2013-09-05,479682,North Carolina,0,4,4
182,2013-08-25,479646,California,0,4,4
55,2013-04-22,484351,Illinois,0,4,4
180,2013-08-25,492270,Minnesota,2,2,4
226371,2018-01-04,1021270,Illinois,1,3,4
228995,2018-01-21,1031851,Illinois,0,4,4
179,2013-08-25,492260,South Carolina,1,3,4
70,2013-05-11,486121,Pennsylvania,0,4,4
127,2013-07-06,490395,Alabama,0,4,4
235324,2018-03-03,1062123,Florida,0,4,4
74,2013-05-13,486316,Ohio,0,4,4
1721,2014-01-11,96391,Texas,3,1,4
351,2014-01-01,92194,Virginia,2,2,4
145,2013-07-19,491082,Connecticut,0,4,4
84,2013-05-24,486971,California,2,2,4
129,2013-07-07,490767,Mississippi,0,4,4
275,2013-12-31,496703,Ohio,3,1,4
131,2013-07-07,490793,Florida,1,3,4
237140,2018-03-15,1070898,Wisconsin,2,2,4
144,2013-07-19,491073,California,0,4,4
32,2013-03-07,481229,Mississippi,2,2,4
177,2013-08-20,491992,Maryland,2,2,4
132,2013-07-09,490909,Maryland,0,4,4
237468,2018-03-17,1071381,Illinois,0,4,4
232037,2018-02-09,1045977,Georgia,2,2,4
88,2013-05-29,487082,Illinois,0,4,4
147,2013-07-21,491214,New York,0,4,4
1666,2014-01-11,95146,Mississippi,0,4,4
68,2013-05-10,486109,California,3,1,4
149,2013-07-25,491243,Michigan,0,4,4
148,2013-07-24,491226,Kansas,0,4,4
190,2013-09-14,479821,North Carolina,0,4,4
259,2013-12-07,495374,Delaware,0,4,4
27,2013-03-02,481186,Louisiana,1,3,4
189,2013-09-12,479757,District of Columbia,1,3,4
28,2013-03-03,481198,Georgia,2,2,4
379,2014-01-01,92174,Illinois,0,4,4
228541,2018-01-18,1029570,Pennsylvania,2,2,4
211,2013-10-02,480747,Nebraska,0,4,4
29,2013-03-03,481208,Michigan,0,4,4
124,2013-07-04,490335,Illinois,0,4,4
258,2013-12-01,495332,Kansas,4,0,4
226612,2018-01-05,1020918,California,4,0,4
256,2013-12-01,495347,Florida,2,2,4
224936,2017-12-25,1014251,Arizona,3,1,4
969,2014-01-05,94514,Pennsylvania,1,3,4
165,2013-08-10,491729,Delaware,0,4,4
30,2013-03-04,481213,California,1,3,4
187,2013-09-11,479774,New York,0,4,4
90,2013-06-01,487261,Wisconsin,0,4,4
229205,2018-01-22,1033501,Ohio,2,2,4
126,2013-07-06,490750,New York,1,3,4
184,2013-09-07,479727,Missouri,1,3,4
89,2013-05-31,487088,Georgia,0,4,4
31,2013-03-05,481220,Indiana,1,3,4
229767,2018-01-25,1035803,District of Columbia,0,4,4
239661,2018-03-31,1081719,North Carolina,0,4,4
175,2013-08-18,491840,Illinois,1,3,4
236877,2018-03-13,1068526,Washington,4,0,4
245,2013-11-21,494116,Pennsylvania,0,4,4
252,2013-11-29,495178,Indiana,0,4,4
80,2013-05-19,486586,Tennessee,2,2,4
225310,2017-12-27,1015666,Nevada,2,2,4
137,2013-07-13,491162,Ohio,0,4,4
226893,2018-01-07,1022055,Florida,0,4,4
43,2013-03-22,483788,New York,1,3,4
251,2013-11-28,495171,New York,0,4,4
250,2013-11-25,494215,Minnesota,1,3,4
226895,2018-01-07,1022375,Michigan,1,3,4
1693,2014-01-11,95313,Oregon,1,3,4
47,2013-04-07,483872,New York,1,3,4
234124,2018-02-23,1056240,Florida,1,3,4
240,2013-11-10,493893,Ohio,1,3,4
229093,2018-01-21,1032393,Florida,0,4,4
77,2013-05-16,486334,Pennsylvania,0,4,4
218,2013-10-09,480981,Texas,4,0,4
81,2013-05-19,486605,Michigan,0,4,4
237046,2018-03-14,1069080,New York,4,0,4
82,2013-05-20,486617,Illinois,0,4,4
236563,2018-03-11,1067264,Illinois,1,3,4
48,2013-04-07,483878,California,1,3,4
172,2013-08-18,491948,New Jersey,0,4,4
49,2013-04-09,484268,Pennsylvania,1,3,4
243,2013-11-15,494033,Texas,1,3,4
139,2013-07-13,490963,Oklahoma,1,3,4
171,2013-08-17,491819,California,0,4,4
241,2013-11-10,493863,Arizona,1,3,4
138,2013-07-13,490979,District of Columbia,0,4,4
42,2013-03-21,483765,Missouri,1,3,4
233699,2018-02-21,1054212,Arizona,4,0,4
173,2013-08-18,491937,Ohio,0,4,4
215,2013-10-06,480897,Arizona,0,4,4
133,2013-07-09,490917,Illinois,2,2,4
166,2013-08-11,491710,New York,0,4,4
224664,2017-12-23,1014971,Louisiana,1,3,4
214,2013-10-05,480882,New York,0,4,4
254,2013-11-30,495268,Georgia,0,4,4
226366,2018-01-04,1020574,Arkansas,1,3,4
232947,2018-02-16,1051291,Oklahoma,1,3,4
253,2013-11-29,495195,California,0,4,4
230200,2018-01-28,1038429,Pennsylvania,4,0,4
53,2013-04-18,484317,Ohio,4,0,4
35,2013-03-13,482801,California,2,2,4
134,2013-07-11,490922,North Carolina,2,2,4
235305,2018-03-03,1061748,New York,1,3,4
929,2014-01-05,125798,Ohio,1,3,4
229685,2018-01-25,1035257,Georgia,3,1,4
79,2013-05-18,486611,Virginia,0,4,4
222,2013-10-20,481254,Florida,0,4,4
168,2013-08-13,491770,Pennsylvania,0,4,4
226881,2018-01-07,1022973,California,4,0,4
37,2013-03-14,482838,California,0,4,4
143,2013-07-17,491046,California,1,3,4
135,2013-07-12,490943,California,1,3,4
235778,2018-03-06,1064221,Missouri,2,2,4
169,2013-08-14,492001,Oklahoma,4,0,4
136,2013-07-12,490954,Kentucky,2,2,4
407,2014-01-01,92602,Michigan,2,2,4
83,2013-05-23,486623,Tennessee,2,2,4
236680,2018-03-12,1068008,Arizona,2,2,4
188,2013-09-12,479747,Tennessee,4,0,4
103,2013-06-16,488134,Illinois,1,3,4
162,2013-08-06,491630,New Jersey,0,4,4
5,2013-01-07,478948,Oklahoma,4,0,4
237879,2018-03-19,1072862,Illinois,1,3,4
235,2013-11-03,492950,California,1,3,4
104,2013-06-21,488426,Illinois,1,3,4
114,2013-06-24,489934,Missouri,1,3,4
61,2013-04-28,485885,Pennsylvania,1,3,4
229795,2018-01-25,1035651,Florida,1,3,4
159,2013-08-04,491546,Missouri,1,3,4
238608,2018-03-24,1077180,Utah,0,4,4
116,2013-06-27,490048,California,2,2,4
59,2013-04-27,485821,Florida,1,3,4
236,2013-11-05,492999,District of Columbia,0,4,4
267,2013-12-25,495577,New York,1,3,4
197,2013-09-17,480453,Nevada,0,4,4
234687,2018-02-27,1059559,Connecticut,0,4,4
226,2013-10-26,481419,Florida,0,4,4
230145,2018-01-27,1037438,Kentucky,0,4,4
8,2013-01-21,479389,California,0,4,4
102,2013-06-15,487891,Texas,1,3,4
10,2013-01-23,491674,Tennessee,1,3,4
155,2013-08-02,491438,Indiana,0,4,4
226068,2018-01-01,1018295,Alabama,1,3,4
11,2013-01-25,479413,Missouri,1,3,4
225173,2017-12-26,1014780,Pennsylvania,2,2,4
235846,2018-03-07,1064514,Alabama,2,2,4
14,2013-01-26,479460,Ohio,1,3,4
614,2014-01-03,92704,New York,1,3,4
4,2013-01-07,478959,North Carolina,2,2,4
227979,2018-01-14,1027013,Alabama,0,4,4
3,2013-01-05,478925,Colorado,4,0,4
236201,2018-03-09,1065908,California,4,0,4
62,2013-04-28,485979,Tennessee,2,2,4
236778,2018-03-13,1078612,Florida,0,4,4
204,2013-09-22,480661,Missouri,1,3,4
65,2013-05-04,486027,North Carolina,0,4,4
263,2013-12-15,495543,Florida,1,3,4
229365,2018-01-23,1034205,Pennsylvania,0,4,4
265,2013-12-21,495557,North Carolina,0,4,4
225136,2017-12-26,1014727,Tennessee,0,4,4
229,2013-10-27,492699,California,0,4,4
227543,2018-01-11,1025272,Missouri,2,2,4
2,2013-01-01,478855,Ohio,1,3,4
261,2013-12-14,495506,North Carolina,0,4,4
233,2013-11-02,492933,Kentucky,1,3,4
208,2013-09-25,480700,North Carolina,0,4,4
224741,2017-12-23,1013377,Alabama,0,4,4
108,2013-06-22,488970,Rhode Island,0,4,4
266,2013-12-22,495566,Michigan,1,3,4
239324,2018-03-29,1080234,Texas,1,3,4
230673,2018-01-31,1040815,Missouri,0,4,4
110,2013-06-23,489096,California,1,3,4
203,2013-09-21,480632,Florida,0,4,4
779,2014-01-04,103940,Georgia,0,4,4
201,2013-09-20,480582,California,2,2,4
236221,2018-03-09,1066594,North Carolina,3,1,4
112,2013-06-23,489121,Louisiana,0,4,4
236737,2018-03-12,1068615,California,0,4,4
16,2013-02-03,479580,California,1,3,4
50,2013-04-10,484279,California,0,4,4
122,2013-07-01,490245,Texas,4,0,4
224397,2017-12-21,1011953,Pennsylvania,1,3,4
92,2013-06-02,487266,Indiana,0,4,4
150,2013-07-26,491253,West Virginia,4,0,4
25,2013-02-23,480407,California,0,4,4
223,2013-10-20,481263,Florida,2,2,4
58,2013-04-25,489185,Ohio,0,4,4
237,2013-11-05,493109,Florida,4,0,4
23,2013-02-21,480383,Oklahoma,1,3,4
120,2013-06-30,490166,Colorado,0,4,4
228339,2018-01-17,1029095,District of Columbia,1,3,4
196,2013-09-17,480415,Michigan,0,4,4
67,2013-05-06,486068,Pennsylvania,0,4,4
225837,2017-12-31,1018118,New Jersey,4,0,4
192,2013-09-15,480058,Georgia,3,1,4
18,2013-02-09,479603,Louisiana,0,4,4
24,2013-02-22,480401,Michigan,0,4,4
100,2013-06-15,488992,Rhode Island,1,3,4
210,2013-09-29,480730,Illinois,0,4,4
91,2013-06-01,489314,California,2,2,4
153,2013-07-29,491281,Washington,0,4,4
226949,2018-01-08,1022547,Texas,4,0,4
233036,2018-02-16,1051839,Michigan,4,0,4
164,2013-08-09,491734,Missouri,2,2,4
96,2013-06-09,487645,Pennsylvania,0,4,4
118,2013-06-29,490150,South Carolina,3,1,4
152,2013-07-28,491287,Texas,0,4,4
239385,2018-03-29,1080442,New Jersey,0,4,4
101,2013-06-15,487833,Tennessee,0,4,4
154,2013-07-30,491292,New Mexico,0,4,4
209,2013-09-27,480720,Ohio,0,4,4
17,2013-02-07,479592,Illinois,0,4,4
228478,2018-01-18,1030296,Alabama,4,0,4
745,2014-01-04,93085,Illinois,2,2,4
138949,2016-08-03,621467,Louisiana,0,3,3
185551,2017-05-05,838650,Georgia,0,3,3
226910,2018-01-07,1022072,Florida,0,3,3
138635,2016-08-01,618558,Illinois,0,3,3
95526,2015-10-22,435542,Ohio,0,3,3
95178,2015-10-19,435750,North Carolina,1,2,3
11456,2014-04-01,121035,Illinois,0,3,3
95579,2015-10-22,436489,Kansas,1,2,3
58557,2015-02-23,296487,Florida,0,3,3
184945,2017-05-01,833322,Iowa,1,2,3
185553,2017-05-05,837463,California,1,2,3
58894,2015-02-26,297840,California,1,2,3
58447,2015-02-22,296763,Georgia,0,3,3
139049,2016-08-04,622190,Louisiana,0,3,3
95632,2015-10-22,436497,Missouri,2,1,3
58406,2015-02-22,296562,Washington,0,3,3
185659,2017-05-05,837810,South Carolina,0,3,3
139279,2016-08-05,622371,Georgia,1,2,3
185645,2017-05-05,836778,Florida,0,3,3
139035,2016-08-04,623767,New York,1,2,3
139268,2016-08-05,622317,Virginia,0,3,3
184531,2017-04-29,848141,Illinois,0,3,3
59351,2015-03-02,300565,North Carolina,0,3,3
138565,2016-08-01,619351,Illinois,0,3,3
227056,2018-01-08,1023137,Illinois,1,2,3
20669,2014-06-08,144125,California,2,1,3
95014,2015-10-18,432527,Indiana,1,2,3
59328,2015-03-02,299666,California,1,2,3
138972,2016-08-03,620256,Florida,1,2,3
95625,2015-10-22,435595,Georgia,3,0,3
95022,2015-10-18,432976,California,1,2,3
95580,2015-10-22,435563,Delaware,0,3,3
185631,2017-05-05,836713,West Virginia,0,3,3
185409,2017-05-03,835925,California,3,0,3
59089,2015-02-28,299424,Hawaii,0,3,3
20589,2014-06-07,144553,California,1,2,3
138749,2016-08-02,620030,Indiana,0,3,3
138980,2016-08-03,620935,Michigan,1,2,3
185255,2017-05-03,836539,North Carolina,0,3,3
138764,2016-08-02,620371,California,3,0,3
58711,2015-02-25,298024,Wisconsin,0,3,3
95356,2015-10-21,434238,Ohio,2,1,3
184763,2017-04-30,832818,Ohio,1,2,3
59027,2015-02-28,299501,Missouri,3,0,3
185107,2017-05-02,835449,California,1,2,3
138857,2016-08-03,621809,Connecticut,0,3,3
58947,2015-02-27,299278,Alabama,1,2,3
139122,2016-08-04,621662,Georgia,1,2,3
58782,2015-02-25,297640,Illinois,1,2,3
226993,2018-01-08,1022911,South Carolina,2,1,3
185205,2017-05-02,835101,Nevada,1,2,3
226999,2018-01-08,1024279,Virginia,2,1,3
58809,2015-02-26,297951,West Virginia,0,3,3
20586,2014-06-07,156419,Ohio,0,3,3
95325,2015-10-20,433484,California,1,2,3
238469,2018-03-23,1076371,Kentucky,3,0,3
184779,2017-04-30,832265,Louisiana,1,2,3
185265,2017-05-03,835974,Michigan,1,2,3
59060,2015-02-28,298742,Ohio,0,3,3
59082,2015-02-28,299230,Mississippi,0,3,3
95219,2015-10-20,433450,California,3,0,3
185721,2017-05-06,837736,Mississippi,1,2,3
184863,2017-04-30,837965,Illinois,0,3,3
227030,2018-01-08,1023284,Florida,0,3,3
184671,2017-04-29,832975,Tennessee,0,3,3
139090,2016-08-04,621890,Louisiana,2,1,3
58856,2015-02-26,297936,Tennessee,3,0,3
226962,2018-01-08,1023288,Florida,0,3,3
138671,2016-08-02,619450,New Jersey,0,3,3
6438,2014-02-16,107546,Washington,0,3,3
139177,2016-08-04,621301,California,1,2,3
184696,2017-04-29,832188,Michigan,0,3,3
59072,2015-02-28,298863,North Carolina,3,0,3
58609,2015-02-24,297229,North Carolina,3,0,3
59256,2015-03-01,299587,California,1,2,3
11512,2014-04-02,121268,North Carolina,0,3,3
95390,2015-10-21,434582,Washington,1,2,3
227012,2018-01-08,1023404,Arizona,1,2,3
6357,2014-02-15,107527,Oklahoma,1,2,3
138698,2016-08-02,619546,Florida,0,3,3
138720,2016-08-02,620445,Michigan,0,3,3
58661,2015-02-24,297317,Nevada,0,3,3
138983,2016-08-03,620761,North Carolina,1,2,3
169129,2017-01-28,762186,North Carolina,1,2,3
138496,2016-07-31,617873,New Jersey,0,3,3
138462,2016-07-31,618515,Indiana,3,0,3
56872,2015-02-08,290661,California,2,1,3
137506,2016-07-26,614869,Pennsylvania,0,3,3
96428,2015-10-28,438697,Illinois,0,3,3
56827,2015-02-08,291369,Pennsylvania,1,2,3
187692,2017-05-16,844543,Tennessee,0,3,3
187720,2017-05-16,846480,Ohio,0,3,3
56802,2015-02-07,290205,Kentucky,1,2,3
56796,2015-02-07,289839,Pennsylvania,0,3,3
187821,2017-05-17,846824,New Jersey,0,3,3
16380,2014-05-09,134086,Florida,1,2,3
137430,2016-07-25,611792,Arkansas,0,3,3
137408,2016-07-25,612243,Illinois,0,3,3
56677,2015-02-06,289822,Alaska,2,1,3
137358,2016-07-25,612553,Indiana,0,3,3
96548,2015-10-29,439102,West Virginia,0,3,3
56647,2015-02-06,289291,West Virginia,1,2,3
187949,2017-05-18,847210,Alabama,2,1,3
187602,2017-05-16,845679,Illinois,0,3,3
56896,2015-02-08,290499,South Carolina,3,0,3
187561,2017-05-16,844728,Florida,1,2,3
187470,2017-05-15,844143,New York,0,3,3
137645,2016-07-27,615145,Florida,3,0,3
57131,2015-02-10,291548,Indiana,3,0,3
96274,2015-10-27,437755,Kentucky,1,2,3
57119,2015-02-10,291559,North Carolina,3,0,3
57108,2015-02-10,291744,Texas,1,2,3
187459,2017-05-15,844312,Louisiana,1,2,3
57035,2015-02-09,292240,Oklahoma,0,3,3
137619,2016-07-26,613785,Arizona,3,0,3
96402,2015-10-28,438334,Indiana,0,3,3
96307,2015-10-27,437865,Louisiana,1,2,3
187520,2017-05-15,844281,South Carolina,0,3,3
96317,2015-10-27,438151,Georgia,1,2,3
238587,2018-03-24,1077217,Texas,0,3,3
56960,2015-02-08,290630,Kansas,0,3,3
56943,2015-02-08,290493,Pennsylvania,0,3,3
137541,2016-07-26,613388,Illinois,1,2,3
187950,2017-05-18,847340,Arizona,2,1,3
56609,2015-02-06,289641,Tennessee,1,2,3
137337,2016-07-25,613050,Tennessee,0,3,3
188369,2017-05-20,848446,Illinois,0,3,3
56342,2015-02-03,287901,Texas,2,1,3
137183,2016-07-24,610674,Connecticut,0,3,3
16358,2014-05-09,133799,Florida,1,2,3
137179,2016-07-24,610773,Florida,0,3,3
56269,2015-02-03,288378,Texas,2,1,3
137174,2016-07-24,611311,Pennsylvania,0,3,3
56211,2015-02-02,362522,Washington,0,3,3
188379,2017-05-20,847930,Florida,3,0,3
137224,2016-07-24,610785,California,1,2,3
188381,2017-05-20,848338,Washington,0,3,3
96784,2015-10-30,439417,Texas,1,2,3
226834,2018-01-07,1022407,Kentucky,0,3,3
56171,2015-02-02,288108,North Carolina,1,2,3
188455,2017-05-21,848535,South Carolina,0,3,3
56164,2015-02-02,287814,Florida,0,3,3
56147,2015-02-01,287017,New Mexico,1,2,3
137223,2016-07-24,612214,Illinois,0,3,3
188199,2017-05-19,847709,Arizona,1,2,3
56587,2015-02-06,289259,North Carolina,2,1,3
96635,2015-10-29,439116,Missouri,0,3,3
96603,2015-10-29,439181,Illinois,0,3,3
20864,2014-06-09,144107,Indiana,0,3,3
6092,2014-02-13,106952,Illinois,0,3,3
6091,2014-02-13,106570,Pennsylvania,3,0,3
188070,2017-05-18,847319,North Carolina,0,3,3
56535,2015-02-05,288891,Massachusetts,1,2,3
6087,2014-02-13,106725,Arkansas,0,3,3
188091,2017-05-18,847767,New Mexico,0,3,3
388,2014-01-01,92292,Indiana,0,3,3
96639,2015-10-29,439134,Tennessee,1,2,3
188110,2017-05-19,847116,Illinois,0,3,3
96671,2015-10-29,441989,North Carolina,2,1,3
137259,2016-07-24,610709,Georgia,1,2,3
188147,2017-05-19,847301,Tennessee,1,2,3
137245,2016-07-24,610733,Virginia,1,2,3
137236,2016-07-24,613630,Illinois,1,2,3
187367,2017-05-15,845155,New Jersey,0,3,3
187355,2017-05-14,843102,Virginia,2,1,3
187351,2017-05-14,843554,Iowa,0,3,3
16460,2014-05-10,134487,Texas,3,0,3
95813,2015-10-24,436083,Georgia,1,2,3
186052,2017-05-07,841906,California,0,3,3
138322,2016-07-30,618027,Wisconsin,0,3,3
186062,2017-05-07,838165,Rhode Island,0,3,3
58062,2015-02-19,295315,Texas,0,3,3
186126,2017-05-08,839065,California,1,2,3
138279,2016-07-30,618683,Rhode Island,0,3,3
95880,2015-10-24,437473,Florida,1,2,3
138369,2016-07-31,617893,Massachusetts,0,3,3
20718,2014-06-08,144745,California,2,1,3
138224,2016-07-30,617657,Illinois,0,3,3
138211,2016-07-30,617007,Tennessee,1,2,3
186382,2017-05-09,839951,District of Columbia,0,3,3
57873,2015-02-17,294189,Tennessee,0,3,3
234823,2018-02-28,1059128,Pennsylvania,2,1,3
138180,2016-07-30,618217,Mississippi,2,1,3
58107,2015-02-19,295276,Texas,0,3,3
185988,2017-05-07,837938,Illinois,0,3,3
20731,2014-06-08,144291,New York,1,2,3
95685,2015-10-23,437017,New Mexico,2,1,3
185828,2017-05-06,837576,Illinois,0,3,3
138452,2016-07-31,617767,Illinois,1,2,3
185855,2017-05-06,837592,Indiana,2,1,3
185860,2017-05-06,837767,California,0,3,3
58356,2015-02-22,296127,Georgia,0,3,3
231099,2018-02-03,1042713,Wisconsin,2,1,3
185868,2017-05-06,837536,Texas,2,1,3
138431,2016-07-31,619126,Nevada,1,2,3
58163,2015-02-20,295756,Arkansas,3,0,3
58330,2015-02-21,296018,Florida,1,2,3
95713,2015-10-23,436281,California,2,1,3
58320,2015-02-21,296247,California,0,3,3
234857,2018-02-28,1060145,Mississippi,2,1,3
58275,2015-02-21,295889,New York,3,0,3
185962,2017-05-07,838252,Washington,0,3,3
58171,2015-02-20,295682,Missouri,3,0,3
238536,2018-03-24,1076929,Pennsylvania,3,0,3
184457,2017-04-28,832156,Georgia,1,2,3
187346,2017-05-14,844917,Arkansas,3,0,3
137748,2016-07-27,614862,Pennsylvania,0,3,3
187067,2017-05-13,842876,New York,0,3,3
57463,2015-02-13,293065,Missouri,2,1,3
57453,2015-02-13,293432,Washington,2,1,3
1123,2014-01-07,105129,Virginia,2,1,3
96171,2015-10-26,437522,Florida,0,3,3
226860,2018-01-07,1023249,Louisiana,1,2,3
137752,2016-07-27,615133,Florida,1,2,3
137747,2016-07-27,614388,Alabama,0,3,3
187039,2017-05-13,842474,Virginia,1,2,3
137738,2016-07-27,615418,Tennessee,0,3,3
137713,2016-07-27,615091,Indiana,2,1,3
187297,2017-05-14,843618,Louisiana,3,0,3
137690,2016-07-27,614374,Florida,2,1,3
137661,2016-07-27,614422,Massachusetts,0,3,3
187336,2017-05-14,843774,Georgia,1,2,3
20802,2014-06-08,146626,Louisiana,0,3,3
137886,2016-07-28,616102,California,1,2,3
57502,2015-02-14,293490,New Mexico,0,3,3
138146,2016-07-30,617095,Virginia,0,3,3
57676,2015-02-15,293810,Alabama,1,2,3
138128,2016-07-29,616258,Colorado,0,3,3
138115,2016-07-29,616648,Michigan,0,3,3
186614,2017-05-10,840747,Pennsylvania,0,3,3
238550,2018-03-24,1077291,Florida,1,2,3
20745,2014-06-08,144068,Michigan,0,3,3
186703,2017-05-11,841532,Louisiana,0,3,3
186730,2017-05-11,840939,Arkansas,3,0,3
57668,2015-02-15,293946,New York,3,0,3
186943,2017-05-12,841767,Kentucky,2,1,3
137983,2016-07-29,779793,Wyoming,0,3,3
186823,2017-05-12,842553,Missouri,1,2,3
137966,2016-07-28,615870,Alabama,0,3,3
57619,2015-02-15,293734,Virginia,1,2,3
186886,2017-05-12,842298,Arkansas,1,2,3
57605,2015-02-15,294815,New Mexico,0,3,3
96091,2015-10-25,436533,South Carolina,2,1,3
238542,2018-03-24,1076895,North Carolina,0,3,3
183737,2017-04-24,828153,New York,0,3,3
59426,2015-03-03,300726,Illinois,1,2,3
180752,2017-04-08,815266,Indiana,0,3,3
11188,2014-03-30,120390,Indiana,3,0,3
180425,2017-04-07,814536,California,0,3,3
180452,2017-04-07,815649,Texas,0,3,3
93293,2015-10-06,426233,New York,1,2,3
62046,2015-03-22,311031,North Carolina,1,2,3
180510,2017-04-07,816118,North Carolina,0,3,3
61976,2015-03-21,310886,Arizona,1,2,3
61970,2015-03-21,311004,Florida,1,2,3
180581,2017-04-08,814846,Georgia,0,3,3
61965,2015-03-21,311429,California,0,3,3
11201,2014-03-30,121731,Indiana,3,0,3
61936,2015-03-21,310650,Ohio,0,3,3
180633,2017-04-08,814613,Florida,3,0,3
61934,2015-03-21,310760,California,0,3,3
141028,2016-08-14,630392,New York,1,2,3
230815,2018-02-01,1040769,Kentucky,2,1,3
180695,2017-04-08,816627,Texas,0,3,3
61888,2015-03-21,311095,Tennessee,0,3,3
93464,2015-10-08,428583,Alabama,1,2,3
180386,2017-04-06,817431,Iowa,3,0,3
141160,2016-08-15,630222,Nebraska,0,3,3
62116,2015-03-22,311843,Wisconsin,0,3,3
141329,2016-08-16,632008,California,0,3,3
93009,2015-10-04,425360,Pennsylvania,0,3,3
141491,2016-08-17,632578,South Carolina,1,2,3
93049,2015-10-05,425874,Texas,0,3,3
93086,2015-10-05,426201,Florida,0,3,3
180024,2017-04-04,811927,California,1,2,3
141397,2016-08-17,631924,District of Columbia,0,3,3
93158,2015-10-05,425586,Louisiana,2,1,3
11169,2014-03-30,120615,Mississippi,0,3,3
62234,2015-03-23,312272,Illinois,0,3,3
141196,2016-08-15,631201,Illinois,0,3,3
180121,2017-04-05,812491,Florida,3,0,3
180169,2017-04-05,812903,Michigan,1,2,3
141310,2016-08-16,631262,Georgia,2,1,3
180228,2017-04-06,814012,Illinois,0,3,3
93232,2015-10-06,427839,North Carolina,2,1,3
141249,2016-08-16,631439,Georgia,1,2,3
180305,2017-04-06,813663,Tennessee,0,3,3
20242,2014-06-05,143350,Washington,1,2,3
61858,2015-03-20,310349,New York,0,3,3
180754,2017-04-08,814659,Maryland,0,3,3
11147,2014-03-30,120249,Mississippi,2,1,3
180769,2017-04-09,819283,Ohio,1,2,3
61523,2015-03-18,310103,Minnesota,0,3,3
140853,2016-08-14,629643,California,2,1,3
140850,2016-08-14,629954,California,1,2,3
140846,2016-08-14,629440,Kentucky,0,3,3
61499,2015-03-18,309103,Missouri,2,1,3
140833,2016-08-14,629879,Virginia,0,3,3
235057,2018-03-01,1061396,Texas,1,2,3
93725,2015-10-10,428654,Pennsylvania,3,0,3
181233,2017-04-11,817370,Illinois,0,3,3
181245,2017-04-11,816706,Tennessee,2,1,3
140803,2016-08-13,628400,Louisiana,1,2,3
140796,2016-08-13,631332,North Carolina,0,3,3
93767,2015-10-10,429228,Florida,0,3,3
238097,2018-03-21,1075508,California,1,2,3
93769,2015-10-10,428751,Nebraska,2,1,3
140775,2016-08-13,628537,Nebraska,0,3,3
181371,2017-04-12,817869,Oregon,3,0,3
140762,2016-08-13,628791,Missouri,2,1,3
181437,2017-04-12,817593,Kentucky,0,3,3
227312,2018-01-10,1024017,New York,3,0,3
11231,2014-03-30,120276,New York,0,3,3
61592,2015-03-19,309822,Maryland,3,0,3
230819,2018-02-01,1041769,California,2,1,3
180781,2017-04-09,815437,Mississippi,2,1,3
140955,2016-08-14,629447,Nebraska,0,3,3
180791,2017-04-09,815511,Florida,0,3,3
61783,2015-03-20,627173,Texas,3,0,3
61781,2015-03-20,311071,Texas,3,0,3
61754,2015-03-20,309850,South Carolina,1,2,3
93546,2015-10-08,428141,New Jersey,0,3,3
180847,2017-04-09,815404,Ohio,0,3,3
180881,2017-04-09,815483,Virginia,0,3,3
93668,2015-10-09,428200,Georgia,1,2,3
180883,2017-04-09,815307,Florida,0,3,3
93603,2015-10-09,428565,Alabama,0,3,3
180903,2017-04-09,816065,Florida,1,2,3
140911,2016-08-14,629981,Louisiana,3,0,3
180923,2017-04-09,815935,Michigan,0,3,3
140905,2016-08-14,630630,Indiana,1,2,3
140900,2016-08-14,629771,New Jersey,0,3,3
227313,2018-01-10,1024588,Arizona,0,3,3
6911,2014-02-21,109017,North Carolina,0,3,3
62518,2015-03-25,312892,Florida,2,1,3
94939,2015-10-18,432940,California,0,3,3
7002,2014-02-22,109647,North Carolina,0,3,3
63515,2015-04-01,316512,Washington,0,3,3
63484,2015-04-01,316077,New York,1,2,3
63478,2015-04-01,316281,Ohio,2,1,3
178726,2017-03-28,806209,Georgia,0,3,3
63465,2015-04-01,316145,California,2,1,3
178781,2017-03-29,806219,Florida,2,1,3
63393,2015-03-31,315993,Florida,0,3,3
178803,2017-03-29,806866,Mississippi,1,2,3
178813,2017-03-29,806368,California,1,2,3
178830,2017-03-29,807271,North Carolina,1,2,3
92524,2015-10-01,425236,Indiana,0,3,3
178920,2017-03-29,806495,Virginia,2,1,3
142031,2016-08-20,635458,North Carolina,0,3,3
11085,2014-03-29,120031,North Carolina,0,3,3
178928,2017-03-29,806239,Connecticut,0,3,3
142025,2016-08-20,634464,Pennsylvania,0,3,3
63293,2015-03-30,315005,Georgia,0,3,3
230687,2018-01-31,1040846,Missouri,0,3,3
63271,2015-03-30,315173,Florida,2,1,3
7036,2014-02-22,109351,Illinois,0,3,3
63541,2015-04-01,316651,Wisconsin,0,3,3
142097,2016-08-21,635099,Georgia,2,1,3
178474,2017-03-27,804659,Oklahoma,3,0,3
237941,2018-03-20,1073877,California,1,2,3
227522,2018-01-11,1024981,North Carolina,2,1,3
92246,2015-09-29,422520,California,3,0,3
178401,2017-03-27,804865,Florida,0,3,3
142249,2016-08-21,635818,California,2,1,3
63764,2015-04-02,316860,South Carolina,0,3,3
178449,2017-03-27,804824,Indiana,3,0,3
7060,2014-02-22,213878,Maryland,3,0,3
11058,2014-03-29,120072,North Carolina,0,3,3
178627,2017-03-28,806558,Nebraska,1,2,3
92324,2015-09-29,422481,Missouri,0,3,3
178496,2017-03-27,804906,Wisconsin,0,3,3
178510,2017-03-27,804964,Tennessee,0,3,3
63685,2015-04-02,317082,California,0,3,3
178545,2017-03-27,805412,North Carolina,1,2,3
142159,2016-08-21,635961,Virginia,0,3,3
178554,2017-03-27,805883,California,0,3,3
178555,2017-03-27,807519,Georgia,0,3,3
142013,2016-08-20,634766,California,1,2,3
6998,2014-02-21,109154,Illinois,0,3,3
141629,2016-08-18,633107,Pennsylvania,0,3,3
92585,2015-10-01,424033,Georgia,0,3,3
141850,2016-08-19,634364,Michigan,0,3,3
62869,2015-03-28,314031,Virginia,0,3,3
92730,2015-10-02,424693,Oregon,2,1,3
20166,2014-06-04,142755,South Carolina,1,2,3
62840,2015-03-27,313656,Massachusetts,1,2,3
92769,2015-10-03,424897,District of Columbia,1,2,3
62812,2015-03-27,313465,Missouri,2,1,3
92783,2015-10-03,425869,Louisiana,0,3,3
179484,2017-04-02,810231,Wisconsin,0,3,3
141754,2016-08-19,633622,Virginia,1,2,3
179538,2017-04-02,809911,California,1,2,3
92817,2015-10-03,424705,Tennessee,3,0,3
179570,2017-04-02,810048,California,0,3,3
62664,2015-03-26,313535,Florida,0,3,3
62658,2015-03-26,313714,Pennsylvania,2,1,3
141656,2016-08-18,632563,Texas,0,3,3
92924,2015-10-04,425746,California,2,1,3
141631,2016-08-18,633065,Texas,3,0,3
62558,2015-03-25,314419,Oklahoma,3,0,3
179405,2017-04-01,810405,Texas,0,3,3
179397,2017-04-01,809689,Oklahoma,2,1,3
230715,2018-01-31,1040805,Texas,1,2,3
141952,2016-08-20,634775,New Jersey,0,3,3
63159,2015-03-30,315724,Louisiana,0,3,3
63140,2015-03-29,315881,Missouri,2,1,3
92586,2015-10-01,424278,Ohio,1,2,3
179054,2017-03-30,807523,South Carolina,2,1,3
63080,2015-03-29,315054,California,1,2,3
63061,2015-03-29,315187,Texas,1,2,3
63052,2015-03-29,315093,California,0,3,3
141953,2016-08-20,635305,Ohio,3,0,3
179192,2017-03-31,808491,South Carolina,0,3,3
141881,2016-08-20,634489,Illinois,0,3,3
179219,2017-03-31,809037,Texas,1,2,3
92693,2015-10-02,424878,Oklahoma,0,3,3
63009,2015-03-28,314973,New Hampshire,3,0,3
63008,2015-03-28,314316,Washington,2,1,3
63005,2015-03-28,314805,Texas,2,1,3
62977,2015-03-28,314009,Tennessee,0,3,3
6970,2014-02-21,109932,Arkansas,0,3,3
92712,2015-10-02,424559,Nevada,3,0,3
181474,2017-04-12,818411,Texas,0,3,3
93789,2015-10-10,429220,Florida,0,3,3
61183,2015-03-16,307543,Illinois,2,1,3
60013,2015-03-08,303617,Florida,0,3,3
183482,2017-04-23,827568,Florida,1,2,3
183501,2017-04-23,826789,Florida,1,2,3
183507,2017-04-23,827515,Florida,1,2,3
94616,2015-10-16,431922,Virginia,1,2,3
20476,2014-06-06,144241,Texas,1,2,3
94620,2015-10-16,431796,Kentucky,2,1,3
60109,2015-03-08,302791,Alaska,1,2,3
139738,2016-08-07,624371,Michigan,0,3,3
139734,2016-08-07,624082,California,1,2,3
183576,2017-04-23,827658,Pennsylvania,3,0,3
139718,2016-08-07,623852,Georgia,1,2,3
230954,2018-02-01,1040759,Michigan,2,1,3
183596,2017-04-23,827645,Arizona,1,2,3
139684,2016-08-07,623533,Mississippi,0,3,3
94718,2015-10-17,432889,Tennessee,1,2,3
139666,2016-08-07,625698,Missouri,0,3,3
94734,2015-10-17,432165,Delaware,2,1,3
6544,2014-02-17,107900,California,1,2,3
60022,2015-03-08,303368,Virginia,0,3,3
60117,2015-03-08,302635,Florida,1,2,3
94612,2015-10-16,431983,Georgia,1,2,3
60124,2015-03-08,303121,New Jersey,2,1,3
60218,2015-03-09,303736,California,1,2,3
139870,2016-08-08,625414,Illinois,1,2,3
139859,2016-08-08,626008,Mississippi,1,2,3
183104,2017-04-21,826138,California,0,3,3
60271,2015-03-10,306151,Idaho,3,0,3
60267,2015-03-10,304666,Michigan,3,0,3
139858,2016-08-08,625546,New Jersey,3,0,3
183166,2017-04-21,826521,California,0,3,3
139850,2016-08-08,624791,California,2,1,3
16611,2014-05-11,134186,Mississippi,1,2,3
139756,2016-08-07,624303,Indiana,1,2,3
183285,2017-04-22,827154,New Jersey,0,3,3
139782,2016-08-07,624494,Missouri,2,1,3
60165,2015-03-09,303777,Texas,3,0,3
139773,2016-08-07,623632,Virginia,2,1,3
139769,2016-08-07,623929,Tennessee,0,3,3
183421,2017-04-22,826149,New Jersey,0,3,3
183438,2017-04-22,826501,California,1,2,3
139764,2016-08-07,624027,New York,0,3,3
94744,2015-10-17,432652,Oklahoma,2,1,3
139641,2016-08-07,624596,Michigan,0,3,3
140695,2016-08-13,628673,California,1,2,3
183717,2017-04-24,827932,Texas,1,2,3
139482,2016-08-06,622829,Arizona,0,3,3
139479,2016-08-06,624489,Missouri,0,3,3
139473,2016-08-06,622835,Pennsylvania,1,2,3
59678,2015-03-05,304386,Kansas,0,3,3
230981,2018-02-02,1041553,California,3,0,3
59659,2015-03-05,301536,Texas,0,3,3
184143,2017-04-26,829464,Missouri,3,0,3
139401,2016-08-06,623730,California,1,2,3
59625,2015-03-04,300891,Georgia,1,2,3
238363,2018-03-23,1076528,California,0,3,3
11431,2014-04-01,121280,Virginia,1,2,3
94915,2015-10-18,432477,Connecticut,0,3,3
139351,2016-08-05,622749,Illinois,0,3,3
6476,2014-02-16,183975,Washington,2,1,3
59499,2015-03-03,300868,Florida,0,3,3
59498,2015-03-03,300880,Texas,0,3,3
231023,2018-02-02,1041668,Missouri,3,0,3
59455,2015-03-03,300530,Louisiana,2,1,3
184406,2017-04-28,832517,Massachusetts,0,3,3
6499,2014-02-17,107686,Florida,0,3,3
94863,2015-10-17,432761,Florida,1,2,3
139500,2016-08-06,622781,Iowa,1,2,3
59951,2015-03-07,303574,Missouri,0,3,3
59992,2015-03-07,302524,Florida,3,0,3
183729,2017-04-24,827984,Texas,1,2,3
387,2014-01-01,92405,New Jersey,0,3,3
238324,2018-03-22,1076345,Mississippi,0,3,3
183747,2017-04-24,827466,Georgia,3,0,3
11397,2014-04-01,120784,Iowa,2,1,3
183758,2017-04-24,828019,South Carolina,0,3,3
6527,2014-02-17,108022,California,0,3,3
183804,2017-04-24,828144,California,0,3,3
184052,2017-04-26,829705,Texas,0,3,3
94816,2015-10-17,432699,Pennsylvania,2,1,3
59922,2015-03-07,302631,California,1,2,3
139581,2016-08-07,626548,Texas,1,2,3
139577,2016-08-07,624120,District of Columbia,0,3,3
139563,2016-08-06,623282,New Jersey,1,2,3
59820,2015-03-06,304003,California,1,2,3
184014,2017-04-26,829865,Arkansas,1,2,3
94847,2015-10-17,432261,Rhode Island,0,3,3
139876,2016-08-08,624485,Missouri,3,0,3
183049,2017-04-20,825022,Missouri,3,0,3
183044,2017-04-20,825335,South Carolina,1,2,3
139891,2016-08-08,625903,Texas,1,2,3
181962,2017-04-15,821333,Pennsylvania,0,3,3
181970,2017-04-15,821025,Florida,2,1,3
181982,2017-04-15,845209,Colorado,3,0,3
182004,2017-04-15,820753,Missouri,1,2,3
182011,2017-04-15,821488,Illinois,0,3,3
61040,2015-03-15,307859,Georgia,0,3,3
182020,2017-04-15,821524,Illinois,0,3,3
238127,2018-03-21,1080884,South Dakota,0,3,3
227264,2018-01-10,1024887,California,1,2,3
61025,2015-03-15,307697,Tennessee,0,3,3
182086,2017-04-15,821598,California,0,3,3
227208,2018-01-09,1023575,North Carolina,0,3,3
93966,2015-10-11,429203,Arizona,2,1,3
20368,2014-06-05,144173,Maryland,3,0,3
182176,2017-04-16,821906,Virginia,0,3,3
94012,2015-10-11,428760,Indiana,0,3,3
60909,2015-03-14,307074,Texas,1,2,3
60897,2015-03-14,307423,Missouri,0,3,3
94018,2015-10-11,428770,South Carolina,1,2,3
93920,2015-10-11,429681,Illinois,0,3,3
93919,2015-10-11,429674,Illinois,1,2,3
61062,2015-03-15,307490,Illinois,0,3,3
61153,2015-03-16,307582,Texas,0,3,3
93806,2015-10-10,430083,Ohio,0,3,3
61174,2015-03-16,308678,Pennsylvania,0,3,3
181607,2017-04-13,819591,California,0,3,3
181640,2017-04-13,819625,Florida,1,2,3
181651,2017-04-13,819692,Connecticut,0,3,3
140667,2016-08-13,628555,Texas,0,3,3
61165,2015-03-16,308156,Missouri,3,0,3
181685,2017-04-13,819477,Illinois,0,3,3
181707,2017-04-13,819718,Kansas,3,0,3
181882,2017-04-14,820763,Alabama,1,2,3
181727,2017-04-13,820080,Mississippi,0,3,3
93839,2015-10-10,428287,Florida,2,1,3
181779,2017-04-14,820447,Missouri,0,3,3
181824,2017-04-14,820454,Georgia,2,1,3
181861,2017-04-14,820720,California,1,2,3
93908,2015-10-11,433172,Mississippi,1,2,3
230837,2018-02-01,1041642,Pennsylvania,0,3,3
181873,2017-04-14,820432,Arizona,2,1,3
227173,2018-01-09,1023559,New York,0,3,3
6686,2014-02-19,153641,Ohio,1,2,3
230866,2018-02-01,1040904,Oklahoma,2,1,3
6628,2014-02-18,107931,Illinois,0,3,3
182556,2017-04-18,823274,California,3,0,3
60682,2015-03-13,308050,Arkansas,1,2,3
140181,2016-08-10,626134,Arizona,1,2,3
182584,2017-04-18,823639,Louisiana,1,2,3
140180,2016-08-10,626666,Washington,0,3,3
20417,2014-06-06,143786,North Carolina,0,3,3
20419,2014-06-06,143317,California,0,3,3
140107,2016-08-09,626165,New Jersey,1,2,3
140055,2016-08-09,625617,Kentucky,2,1,3
60691,2015-03-13,306271,Florida,0,3,3
94364,2015-10-14,430932,Delaware,0,3,3
60459,2015-03-11,304897,Missouri,1,2,3
94391,2015-10-14,430295,Tennessee,0,3,3
182903,2017-04-20,825280,Georgia,0,3,3
60424,2015-03-11,304547,Texas,3,0,3
182922,2017-04-20,846305,North Carolina,0,3,3
182952,2017-04-20,825863,Tennessee,1,2,3
182991,2017-04-20,825633,Florida,3,0,3
94198,2015-10-13,430718,North Carolina,0,3,3
182505,2017-04-17,822114,Pennsylvania,0,3,3
60856,2015-03-14,307097,Tennessee,0,3,3
60798,2015-03-13,306700,Ohio,2,1,3
94044,2015-10-12,429042,New York,1,2,3
182291,2017-04-16,821964,District of Columbia,0,3,3
94071,2015-10-12,429258,Florida,0,3,3
140283,2016-08-11,627743,Virginia,1,2,3
6675,2014-02-19,109468,New York,0,3,3
60806,2015-03-13,306756,New York,1,2,3
140279,2016-08-10,626183,North Carolina,0,3,3
182360,2017-04-16,822321,Florida,0,3,3
182389,2017-04-17,822853,Delaware,0,3,3
6656,2014-02-18,108243,Florida,3,0,3
182396,2017-04-17,822128,Texas,2,1,3
60783,2015-03-13,307121,Oregon,0,3,3
6666,2014-02-18,108104,Virginia,0,3,3
60769,2015-03-13,307989,Alabama,1,2,3
140230,2016-08-10,626108,Ohio,3,0,3
140213,2016-08-10,625854,Arkansas,1,2,3
182484,2017-04-17,822053,Ohio,2,1,3
94169,2015-10-13,434806,Illinois,0,3,3
188475,2017-05-21,848558,Oklahoma,0,3,3
136733,2016-07-22,610214,New Jersey,1,2,3
188480,2017-05-21,848469,Illinois,0,3,3
195584,2017-06-30,880506,Alabama,0,3,3
100164,2015-11-22,453357,South Carolina,1,2,3
195272,2017-06-28,878038,Louisiana,0,3,3
133429,2016-07-02,593322,Illinois,3,0,3
195349,2017-06-28,879139,California,0,3,3
100217,2015-11-23,455051,Arkansas,0,3,3
133345,2016-07-01,593844,Arizona,3,0,3
50399,2014-12-18,269968,Arkansas,0,3,3
195400,2017-06-29,878414,Maryland,0,3,3
21545,2014-06-14,146641,Illinois,3,0,3
195458,2017-06-29,879209,South Carolina,2,1,3
133306,2016-07-01,593882,Mississippi,2,1,3
133290,2016-07-01,593440,California,0,3,3
195487,2017-06-29,879019,Nevada,1,2,3
133277,2016-07-01,592824,New York,0,3,3
12230,2014-04-07,123151,Illinois,0,3,3
195532,2017-06-29,878898,Tennessee,0,3,3
133228,2016-06-30,592746,Alabama,0,3,3
195557,2017-06-29,878601,Texas,2,1,3
50250,2014-12-17,267829,Arkansas,3,0,3
195203,2017-06-28,877903,Alabama,1,2,3
100160,2015-11-22,452068,Nevada,1,2,3
50502,2014-12-19,266293,Virginia,0,3,3
133545,2016-07-02,593690,Indiana,2,1,3
12191,2014-04-07,123362,Texas,2,1,3
133578,2016-07-02,594887,Georgia,0,3,3
100074,2015-11-22,455709,Iowa,2,1,3
194933,2017-06-26,876290,Tennessee,1,2,3
194942,2017-06-26,875981,South Carolina,2,1,3
238983,2018-03-26,1078200,Illinois,0,3,3
50642,2014-12-20,266063,New York,3,0,3
133555,2016-07-02,594320,Missouri,0,3,3
50593,2014-12-20,266468,Missouri,1,2,3
133460,2016-07-02,593662,Rhode Island,0,3,3
234468,2018-02-25,1057931,California,2,1,3
234459,2018-02-25,1056854,Arizona,1,2,3
133506,2016-07-02,593749,Ohio,2,1,3
100127,2015-11-22,452648,Minnesota,2,1,3
195080,2017-06-27,877435,Illinois,0,3,3
195085,2017-06-27,877890,North Carolina,1,2,3
195112,2017-06-27,877518,Georgia,3,0,3
133474,2016-07-02,593627,Florida,0,3,3
195563,2017-06-29,878443,Tennessee,0,3,3
50248,2014-12-17,264710,California,1,2,3
100800,2015-11-27,454802,New Jersey,0,3,3
5202,2014-02-04,104390,South Carolina,0,3,3
132897,2016-06-28,591751,Idaho,1,2,3
100622,2015-11-26,454416,Michigan,3,0,3
132886,2016-06-28,591237,Texas,3,0,3
100645,2015-11-26,453697,Alabama,2,1,3
49851,2014-12-14,264405,Missouri,0,3,3
195964,2017-07-02,881179,Missouri,0,3,3
195985,2017-07-02,880625,Illinois,2,1,3
100686,2015-11-26,453527,Texas,0,3,3
195993,2017-07-02,882138,New Jersey,0,3,3
5139,2014-02-04,162929,Florida,1,2,3
196014,2017-07-02,881429,Illinois,0,3,3
196022,2017-07-02,881496,Georgia,1,2,3
132843,2016-06-28,590544,Michigan,0,3,3
132810,2016-06-27,590351,Illinois,0,3,3
196044,2017-07-02,881682,Massachusetts,0,3,3
196048,2017-07-02,880578,Alabama,1,2,3
49748,2014-12-13,263087,California,0,3,3
49726,2014-12-13,263155,Illinois,0,3,3
196088,2017-07-02,881273,Louisiana,0,3,3
195891,2017-07-02,881409,Tennessee,1,2,3
132898,2016-06-28,592644,Rhode Island,0,3,3
226238,2018-01-03,1020537,Texas,2,1,3
50064,2014-12-15,263532,Texas,0,3,3
195604,2017-06-30,879512,Maryland,0,3,3
5199,2014-02-04,103955,Tennessee,0,3,3
100332,2015-11-24,453062,California,1,2,3
133211,2016-06-30,592977,Arkansas,0,3,3
133207,2016-06-30,592982,Missouri,2,1,3
195678,2017-06-30,880112,Illinois,3,0,3
50134,2014-12-16,264670,South Carolina,0,3,3
133158,2016-06-30,596007,Colorado,2,1,3
15918,2014-05-06,211531,South Carolina,0,3,3
132924,2016-06-28,590780,Maryland,0,3,3
195765,2017-07-01,880477,Florida,0,3,3
133030,2016-06-29,591701,Michigan,1,2,3
133006,2016-06-29,591591,Georgia,0,3,3
1652,2014-01-11,95487,Texas,2,1,3
49954,2014-12-15,264453,New York,1,2,3
195822,2017-07-01,880825,New Jersey,0,3,3
132959,2016-06-28,590627,Florida,2,1,3
5161,2014-02-04,104523,Tennessee,0,3,3
133616,2016-07-03,593977,Minnesota,1,2,3
50725,2014-12-21,267278,North Carolina,0,3,3
50765,2014-12-21,266756,Nebraska,2,1,3
12185,2014-04-07,123036,Illinois,1,2,3
51482,2014-12-27,269601,North Carolina,0,3,3
193991,2017-06-20,871988,Illinois,1,2,3
51440,2014-12-27,269823,Pennsylvania,0,3,3
51410,2014-12-26,269658,North Carolina,1,2,3
134036,2016-07-05,595544,Illinois,0,3,3
231602,2018-02-06,1044829,Indiana,0,3,3
134009,2016-07-05,595896,Missouri,3,0,3
134003,2016-07-05,595475,Illinois,1,2,3
51345,2014-12-26,270680,North Carolina,1,2,3
194143,2017-06-21,872982,Illinois,0,3,3
51303,2014-12-26,269923,Louisiana,1,2,3
51283,2014-12-25,268872,Florida,3,0,3
133955,2016-07-04,594931,West Virginia,1,2,3
194175,2017-06-21,873814,Illinois,0,3,3
194177,2017-06-21,871965,Ohio,0,3,3
51270,2014-12-25,270662,Oklahoma,0,3,3
51263,2014-12-25,269147,Florida,1,2,3
51252,2014-12-25,269310,Massachusetts,0,3,3
51244,2014-12-25,269368,New York,0,3,3
51488,2014-12-27,270105,Alabama,1,2,3
193964,2017-06-20,872913,Louisiana,0,3,3
51494,2014-12-27,270122,Alabama,1,2,3
99470,2015-11-17,449266,Texas,0,3,3
51742,2014-12-28,270352,Texas,1,2,3
134199,2016-07-06,597032,California,0,3,3
193677,2017-06-19,872716,Idaho,3,0,3
193690,2017-06-19,870820,Tennessee,1,2,3
193710,2017-06-19,870995,Pennsylvania,1,2,3
51673,2014-12-28,270346,District of Columbia,0,3,3
51644,2014-12-28,270418,Illinois,2,1,3
21392,2014-06-13,145880,Illinois,0,3,3
51639,2014-12-28,270972,Texas,3,0,3
134067,2016-07-05,595678,Massachusetts,0,3,3
51635,2014-12-28,270002,Ohio,0,3,3
193786,2017-06-19,870607,Minnesota,0,3,3
21396,2014-06-13,146822,New York,0,3,3
99509,2015-11-17,449100,Pennsylvania,0,3,3
51558,2014-12-27,270639,Texas,1,2,3
99532,2015-11-18,450143,Virginia,1,2,3
134107,2016-07-05,595387,New York,0,3,3
24231,2014-07-02,155297,Missouri,0,3,3
194233,2017-06-22,873444,Tennessee,2,1,3
12136,2014-04-06,123844,Virginia,0,3,3
99694,2015-11-19,450729,Kentucky,3,0,3
194743,2017-06-25,875880,Louisiana,0,3,3
50918,2014-12-22,267540,Ohio,2,1,3
50883,2014-12-22,269493,Minnesota,0,3,3
133719,2016-07-03,593935,North Carolina,1,2,3
194707,2017-06-25,875235,New York,0,3,3
15982,2014-05-06,132526,District of Columbia,0,3,3
238941,2018-03-26,1078659,Florida,0,3,3
194736,2017-06-25,876427,Nevada,2,1,3
194740,2017-06-25,875479,Michigan,0,3,3
194748,2017-06-25,875959,Georgia,2,1,3
194617,2017-06-24,874660,Minnesota,0,3,3
133704,2016-07-03,594189,Pennsylvania,0,3,3
194754,2017-06-25,876537,Louisiana,0,3,3
194760,2017-06-25,875561,Indiana,0,3,3
133701,2016-07-03,593962,Oklahoma,1,2,3
100022,2015-11-21,452920,Missouri,3,0,3
100027,2015-11-21,451483,Missouri,3,0,3
100043,2015-11-21,451705,California,1,2,3
194838,2017-06-25,875381,Ohio,1,2,3
194619,2017-06-24,874897,North Carolina,0,3,3
231647,2018-02-06,1045091,Alabama,0,3,3
194299,2017-06-22,873513,Florida,0,3,3
133822,2016-07-04,595346,Tennessee,1,2,3
194303,2017-06-22,873587,West Virginia,2,1,3
51147,2014-12-24,269280,Florida,0,3,3
5348,2014-02-06,104666,Georgia,3,0,3
194322,2017-06-22,873468,Tennessee,2,1,3
133876,2016-07-04,594868,Nevada,0,3,3
99840,2015-11-20,497840,California,1,2,3
194377,2017-06-23,874621,Georgia,0,3,3
133825,2016-07-04,595002,Missouri,2,1,3
194425,2017-06-23,874206,Kentucky,2,1,3
194607,2017-06-24,875142,Nevada,0,3,3
194517,2017-06-24,875311,Illinois,0,3,3
50992,2014-12-23,268867,Mississippi,1,2,3
50979,2014-12-23,267986,North Carolina,0,3,3
133775,2016-07-04,595552,California,1,2,3
238890,2018-03-26,1078144,Texas,2,1,3
12160,2014-04-06,122656,Connecticut,0,3,3
50960,2014-12-22,267276,Nevada,0,3,3
133765,2016-07-04,595490,Arizona,1,2,3
196130,2017-07-03,882816,North Carolina,0,3,3
196202,2017-07-03,882183,Michigan,0,3,3
193631,2017-06-18,870660,Illinois,0,3,3
47946,2014-11-28,225860,Virginia,0,3,3
231866,2018-02-08,1045650,California,1,2,3
315,2014-01-01,94194,Alabama,0,3,3
197749,2017-07-11,888146,Missouri,0,3,3
48117,2014-11-29,225983,Florida,0,3,3
48106,2014-11-29,226069,Nebraska,0,3,3
131783,2016-06-21,586159,Florida,0,3,3
131768,2016-06-21,585265,Virginia,1,2,3
48044,2014-11-29,225924,Texas,1,2,3
197857,2017-07-12,889654,New Jersey,0,3,3
101730,2015-12-04,459135,North Carolina,3,0,3
239241,2018-03-28,1080524,South Carolina,0,3,3
131755,2016-06-21,586698,California,1,2,3
131749,2016-06-21,585640,Connecticut,2,1,3
47991,2014-11-28,225568,Illinois,1,2,3
47981,2014-11-28,225936,Missouri,1,2,3
197976,2017-07-13,889640,Pennsylvania,0,3,3
197982,2017-07-13,889765,Ohio,0,3,3
131740,2016-06-21,585431,Pennsylvania,0,3,3
101810,2015-12-05,460593,California,1,2,3
48158,2014-11-30,226200,California,0,3,3
48164,2014-11-30,226511,New Jersey,1,2,3
197638,2017-07-11,888689,Virginia,0,3,3
197450,2017-07-09,886831,Illinois,0,3,3
197410,2017-07-09,887007,New York,2,1,3
234309,2018-02-24,1056378,California,1,2,3
101589,2015-12-03,458718,Michigan,2,1,3
1672,2014-01-11,98285,Wisconsin,0,3,3
231855,2018-02-08,1046654,Missouri,1,2,3
48320,2014-12-01,226938,Oklahoma,1,2,3
197441,2017-07-09,886532,New York,0,3,3
197442,2017-07-09,886823,Illinois,0,3,3
48302,2014-12-01,226718,Michigan,2,1,3
48169,2014-11-30,226451,North Carolina,3,0,3
48258,2014-11-30,226289,Oregon,0,3,3
197511,2017-07-10,887667,Nevada,3,0,3
48245,2014-11-30,266909,Michigan,0,3,3
239201,2018-03-28,1080536,South Carolina,1,2,3
48221,2014-11-30,226960,Pennsylvania,0,3,3
101655,2015-12-03,458543,District of Columbia,0,3,3
101656,2015-12-03,458560,Florida,1,2,3
48192,2014-11-30,226625,North Carolina,3,0,3
4885,2014-02-02,103328,Illinois,3,0,3
4883,2014-02-02,103900,Maryland,0,3,3
49614,2014-12-12,262449,Connecticut,0,3,3
198010,2017-07-13,889854,Missouri,0,3,3
198478,2017-07-15,890790,California,0,3,3
131487,2016-06-19,584212,Florida,1,2,3
15755,2014-05-04,132032,California,0,3,3
198530,2017-07-16,891276,Kentucky,0,3,3
198542,2017-07-16,891426,Missouri,0,3,3
234290,2018-02-24,1056455,Ohio,0,3,3
198552,2017-07-16,891373,Missouri,1,2,3
21848,2014-06-16,146796,Illinois,0,3,3
102080,2015-12-06,459981,Illinois,0,3,3
234288,2018-02-24,1056358,Kentucky,0,3,3
198609,2017-07-16,891587,Indiana,3,0,3
131395,2016-06-19,584187,New Jersey,0,3,3
47497,2014-11-23,274454,Texas,1,2,3
47488,2014-11-23,260071,California,2,1,3
47484,2014-11-23,224815,Virginia,0,3,3
198699,2017-07-17,892777,Florida,0,3,3
47469,2014-11-23,224105,Texas,1,2,3
21870,2014-06-16,149546,Louisiana,0,3,3
15732,2014-05-04,131810,South Carolina,0,3,3
47644,2014-11-25,225564,Ohio,1,2,3
102005,2015-12-06,460509,Nevada,1,2,3
226026,2018-01-01,1019146,California,0,3,3
12445,2014-04-09,123974,New Jersey,1,2,3
15776,2014-05-04,132013,California,1,2,3
47918,2014-11-27,225560,Oregon,2,1,3
131695,2016-06-21,585364,Tennessee,2,1,3
198154,2017-07-14,890585,Illinois,1,2,3
101821,2015-12-05,471627,Ohio,0,3,3
131678,2016-06-20,584248,Florida,1,2,3
101845,2015-12-05,459964,Texas,1,2,3
198197,2017-07-14,890621,Texas,0,3,3
131653,2016-06-20,585496,Indiana,0,3,3
21833,2014-06-16,146887,Indiana,1,2,3
131651,2016-06-20,586470,Florida,0,3,3
47770,2014-11-26,225071,Missouri,1,2,3
101913,2015-12-05,460310,Georgia,0,3,3
131579,2016-06-20,585327,Florida,0,3,3
131559,2016-06-20,584283,Maryland,0,3,3
131546,2016-06-20,583856,Illinois,0,3,3
21829,2014-06-16,146895,Texas,0,3,3
101954,2015-12-05,459901,North Carolina,1,2,3
48396,2014-12-02,227103,Georgia,1,2,3
101577,2015-12-03,458549,New York,2,1,3
21749,2014-06-15,146836,District of Columbia,1,2,3
48438,2014-12-02,227195,Illinois,2,1,3
5079,2014-02-03,103451,Florida,1,2,3
196419,2017-07-04,883767,Pennsylvania,1,2,3
49324,2014-12-10,261633,Colorado,3,0,3
196457,2017-07-04,884091,South Carolina,0,3,3
12320,2014-04-08,124759,Alabama,0,3,3
132521,2016-06-26,588854,Illinois,0,3,3
196519,2017-07-05,883578,Indiana,0,3,3
196520,2017-07-05,882961,New York,2,1,3
196544,2017-07-05,883353,Florida,2,1,3
231768,2018-02-07,1045259,Connecticut,0,3,3
196558,2017-07-05,884196,Arizona,0,3,3
12331,2014-04-08,124558,Arkansas,3,0,3
132474,2016-06-26,588789,Kentucky,1,2,3
196629,2017-07-05,883400,New York,2,1,3
100989,2015-11-29,455496,Pennsylvania,3,0,3
196660,2017-07-05,883642,Missouri,1,2,3
132421,2016-06-25,587765,California,1,2,3
196703,2017-07-05,883204,Illinois,1,2,3
231785,2018-02-07,1044795,Alabama,0,3,3
49353,2014-12-10,262029,Mississippi,3,0,3
132571,2016-06-26,588451,Illinois,1,2,3
132585,2016-06-26,589572,New York,0,3,3
196251,2017-07-03,882307,Florida,1,2,3
49607,2014-12-12,262098,Georgia,0,3,3
196214,2017-07-03,881731,Alabama,1,2,3
132652,2016-06-26,589412,California,1,2,3
49579,2014-12-12,262697,California,0,3,3
196225,2017-07-03,882446,Arkansas,0,3,3
196230,2017-07-03,882483,New Jersey,0,3,3
100818,2015-11-27,454516,District of Columbia,0,3,3
196243,2017-07-03,882408,Massachusetts,0,3,3
196255,2017-07-03,882119,Louisiana,2,1,3
132595,2016-06-26,588986,Nevada,1,2,3
132638,2016-06-26,589322,Nebraska,2,1,3
49555,2014-12-12,263370,Texas,1,2,3
49553,2014-12-12,263710,Texas,1,2,3
132619,2016-06-26,589356,Tennessee,1,2,3
49496,2014-12-11,261869,Georgia,0,3,3
196328,2017-07-04,883939,California,0,3,3
231749,2018-02-07,1045068,North Carolina,0,3,3
226188,2018-01-02,1020795,Texas,1,2,3
21690,2014-06-15,147875,Missouri,0,3,3
324,2014-01-01,92479,Florida,0,3,3
132374,2016-06-25,589219,Oklahoma,1,2,3
4972,2014-02-03,103447,Florida,0,3,3
48664,2014-12-04,259548,Missouri,1,2,3
48662,2014-12-04,248881,Florida,3,0,3
132178,2016-06-24,589336,Mississippi,1,2,3
132165,2016-06-24,588089,New Jersey,0,3,3
101388,2015-12-01,456875,Illinois,0,3,3
132148,2016-06-24,587690,Pennsylvania,3,0,3
197235,2017-07-08,885946,South Carolina,0,3,3
197238,2017-07-08,886250,Illinois,0,3,3
197277,2017-07-09,886902,New Jersey,0,3,3
197165,2017-07-08,886245,Illinois,0,3,3
197293,2017-07-09,886955,North Carolina,0,3,3
321,2014-01-01,92328,Arizona,3,0,3
48544,2014-12-03,227549,Pennsylvania,0,3,3
101520,2015-12-02,458098,Texas,1,2,3
48461,2014-12-02,227422,Michigan,0,3,3
4958,2014-02-02,103588,Kansas,1,2,3
197348,2017-07-09,886241,New York,0,3,3
234311,2018-02-24,1056808,District of Columbia,0,3,3
197195,2017-07-08,886162,Iowa,0,3,3
48680,2014-12-04,261048,Alabama,3,0,3
132338,2016-06-25,588237,Kentucky,3,0,3
197005,2017-07-07,886166,Texas,2,1,3
196817,2017-07-06,891058,Texas,0,3,3
48923,2014-12-06,260539,Florida,3,0,3
196837,2017-07-06,884842,Missouri,0,3,3
132336,2016-06-25,591613,Ohio,0,3,3
132332,2016-06-25,589192,Pennsylvania,3,0,3
48865,2014-12-06,261305,South Carolina,1,2,3
196982,2017-07-07,886174,Texas,0,3,3
132270,2016-06-24,587523,Texas,3,0,3
226094,2018-01-01,1019113,California,0,3,3
197154,2017-07-08,886678,Colorado,0,3,3
197060,2017-07-07,884930,Georgia,1,2,3
197063,2017-07-08,885905,New Jersey,0,3,3
48757,2014-12-05,259725,California,0,3,3
132252,2016-06-24,592324,Maryland,1,2,3
197091,2017-07-08,886740,Arizona,2,1,3
226093,2018-01-01,1019029,Ohio,2,1,3
101308,2015-12-01,456105,Texas,2,1,3
197144,2017-07-08,885856,Pennsylvania,0,3,3
193643,2017-06-18,870691,Texas,0,3,3
193623,2017-06-18,872189,Georgia,3,0,3
231163,2018-02-03,1042306,Wisconsin,0,3,3
190427,2017-05-31,857206,Minnesota,3,0,3
136036,2016-07-17,608211,Florida,0,3,3
190167,2017-05-29,854582,Arizona,1,2,3
135998,2016-07-17,606853,California,0,3,3
54567,2015-01-20,281710,Ohio,0,3,3
54550,2015-01-20,281720,District of Columbia,0,3,3
54543,2015-01-20,281842,West Virginia,2,1,3
54531,2015-01-20,282826,Pennsylvania,1,2,3
54489,2015-01-19,280742,Wisconsin,1,2,3
190302,2017-05-30,855943,Texas,3,0,3
226732,2018-01-06,1021780,New York,1,2,3
190339,2017-05-30,856170,Pennsylvania,0,3,3
135968,2016-07-17,605597,Iowa,1,2,3
97686,2015-11-05,443318,Texas,0,3,3
5819,2014-02-10,105816,North Carolina,0,3,3
190358,2017-05-30,856135,Louisiana,0,3,3
97690,2015-11-05,443515,Illinois,0,3,3
135955,2016-07-17,606861,California,0,3,3
54448,2015-01-19,281473,California,1,2,3
5814,2014-02-10,107992,Michigan,3,0,3
54643,2015-01-20,281032,California,0,3,3
16245,2014-05-08,133134,Illinois,0,3,3
190099,2017-05-29,855262,New York,0,3,3
136111,2016-07-18,605775,New York,0,3,3
189886,2017-05-28,853996,Washington,0,3,3
189924,2017-05-28,853854,Virginia,1,2,3
136145,2016-07-18,606506,Kansas,0,3,3
189936,2017-05-28,853926,Colorado,0,3,3
189942,2017-05-28,854123,Pennsylvania,3,0,3
21042,2014-06-10,145620,Delaware,1,2,3
189961,2017-05-28,854587,Arkansas,1,2,3
97508,2015-11-04,442631,Florida,1,2,3
5860,2014-02-10,105249,Indiana,0,3,3
136046,2016-07-17,605663,Louisiana,0,3,3
189975,2017-05-29,855560,Georgia,1,2,3
97514,2015-11-04,442638,Florida,1,2,3
190019,2017-05-29,855520,Illinois,0,3,3
231276,2018-02-04,1043175,Mississippi,1,2,3
190033,2017-05-29,855524,Illinois,1,2,3
190043,2017-05-29,855515,Illinois,1,2,3
97571,2015-11-04,442509,Pennsylvania,2,1,3
54664,2015-01-20,282561,California,3,0,3
190420,2017-05-31,857453,Virginia,1,2,3
190442,2017-05-31,857108,Alabama,1,2,3
98000,2015-11-07,444937,North Carolina,0,3,3
11859,2014-04-04,122114,Alabama,1,2,3
97833,2015-11-06,443233,New Jersey,1,2,3
190830,2017-06-02,858882,California,0,3,3
54223,2015-01-17,279586,Illinois,0,3,3
97835,2015-11-06,443589,Illinois,1,2,3
54188,2015-01-17,279566,Florida,2,1,3
5765,2014-02-09,105683,California,1,2,3
135857,2016-07-16,605180,Minnesota,1,2,3
97865,2015-11-06,443832,New York,0,3,3
231309,2018-02-04,1043136,North Carolina,2,1,3
135836,2016-07-16,605001,California,1,2,3
135832,2016-07-16,604695,Connecticut,0,3,3
190912,2017-06-03,911700,Michigan,0,3,3
97893,2015-11-06,443097,Illinois,0,3,3
135824,2016-07-16,604297,Ohio,0,3,3
5755,2014-02-09,105225,Illinois,0,3,3
190965,2017-06-03,859855,California,0,3,3
54055,2015-01-16,279708,California,1,2,3
54050,2015-01-16,279478,Missouri,2,1,3
54040,2015-01-16,279209,Florida,2,1,3
54257,2015-01-17,279636,Tennessee,2,1,3
135883,2016-07-17,606005,District of Columbia,0,3,3
54277,2015-01-18,280971,Florida,2,1,3
54353,2015-01-18,280198,Minnesota,3,0,3
16229,2014-05-08,132921,Ohio,0,3,3
190511,2017-05-31,857584,Pennsylvania,2,1,3
135929,2016-07-17,605556,North Carolina,0,3,3
54398,2015-01-19,281559,Pennsylvania,1,2,3
5801,2014-02-10,105424,Arkansas,1,2,3
190541,2017-05-31,857733,Mississippi,0,3,3
190552,2017-05-31,856531,Mississippi,2,1,3
54374,2015-01-18,280153,Alabama,0,3,3
226729,2018-01-06,1021916,Tennessee,0,3,3
54279,2015-01-18,280895,New Jersey,1,2,3
190576,2017-06-01,857613,Indiana,3,0,3
21094,2014-06-11,145396,Utah,1,2,3
190636,2017-06-01,857937,Illinois,1,2,3
97774,2015-11-05,443399,Pennsylvania,0,3,3
97777,2015-11-05,443258,Connecticut,1,2,3
16219,2014-05-08,133169,Idaho,2,1,3
190725,2017-06-02,858330,Virginia,1,2,3
21102,2014-06-11,145485,Arizona,0,3,3
136184,2016-07-18,609362,New Jersey,0,3,3
189865,2017-05-28,854087,Illinois,0,3,3
136187,2016-07-18,606436,North Carolina,0,3,3
54944,2015-01-23,283300,Delaware,1,2,3
136917,2016-07-23,611103,Louisiana,0,3,3
231215,2018-02-03,1042532,Colorado,2,1,3
20935,2014-06-09,144152,Washington,2,1,3
136891,2016-07-23,610228,Florida,2,1,3
96936,2015-10-31,440128,Illinois,0,3,3
55810,2015-01-30,285928,Ohio,2,1,3
231220,2018-02-03,1042240,Michigan,3,0,3
136858,2016-07-22,609770,Illinois,0,3,3
5991,2014-02-12,106365,Tennessee,1,2,3
188925,2017-05-23,850249,Pennsylvania,1,2,3
96982,2015-10-31,439991,South Carolina,1,2,3
55673,2015-01-29,285866,North Carolina,0,3,3
136798,2016-07-22,609604,California,3,0,3
97002,2015-11-01,440780,New York,0,3,3
55644,2015-01-28,285728,Alabama,0,3,3
189049,2017-05-24,851537,California,1,2,3
189074,2017-05-24,851007,Tennessee,1,2,3
226803,2018-01-07,1022524,South Carolina,2,1,3
189092,2017-05-24,851143,Missouri,0,3,3
55881,2015-01-30,286570,Georgia,0,3,3
55894,2015-01-30,286348,Florida,0,3,3
188676,2017-05-22,850121,Michigan,3,0,3
188628,2017-05-22,849980,Illinois,2,1,3
188483,2017-05-21,848450,Illinois,1,2,3
137066,2016-07-24,611817,New York,0,3,3
137044,2016-07-23,610532,New Jersey,1,2,3
56107,2015-02-01,287186,South Carolina,0,3,3
20911,2014-06-09,151171,Arizona,3,0,3
56022,2015-01-31,286879,Texas,0,3,3
136974,2016-07-23,610446,Louisiana,1,2,3
188610,2017-05-21,848738,New York,0,3,3
20923,2014-06-09,144549,Washington,2,1,3
188675,2017-05-22,850202,Minnesota,0,3,3
96905,2015-10-31,439575,Virginia,1,2,3
136932,2016-07-23,610803,Indiana,0,3,3
188660,2017-05-22,849701,Tennessee,0,3,3
188662,2017-05-22,898397,Oklahoma,3,0,3
96914,2015-10-31,440591,California,1,2,3
6010,2014-02-12,106215,North Carolina,3,0,3
55934,2015-01-31,286871,Florida,0,3,3
231203,2018-02-03,1042224,South Carolina,1,2,3
136776,2016-07-22,609685,Indiana,3,0,3
20962,2014-06-10,144755,Oregon,2,1,3
20077,2014-06-04,142583,Indiana,0,3,3
55115,2015-01-24,283722,California,2,1,3
136468,2016-07-20,607737,Virginia,0,3,3
97263,2015-11-02,441596,Nebraska,0,3,3
97265,2015-11-02,441139,Illinois,0,3,3
189564,2017-05-27,853275,Florida,0,3,3
136425,2016-07-19,606741,Missouri,0,3,3
189608,2017-05-27,856393,Illinois,0,3,3
189609,2017-05-27,853023,Florida,1,2,3
97322,2015-11-02,442774,Kansas,3,0,3
189647,2017-05-27,853444,North Carolina,1,2,3
55241,2015-01-25,283629,Maryland,0,3,3
231254,2018-02-04,1042488,Illinois,1,2,3
97351,2015-11-03,442801,Montana,1,2,3
226757,2018-01-06,1022379,Michigan,2,1,3
189746,2017-05-28,854440,Texas,1,2,3
136232,2016-07-18,607147,Texas,0,3,3
189808,2017-05-28,854515,Florida,2,1,3
238671,2018-03-25,1077257,Florida,3,0,3
189847,2017-05-28,854457,Michigan,0,3,3
189521,2017-05-27,853141,South Carolina,0,3,3
55244,2015-01-25,283953,Michigan,2,1,3
97042,2015-11-01,440356,Ohio,0,3,3
189313,2017-05-25,852227,California,0,3,3
189177,2017-05-25,852068,New Jersey,1,2,3
136705,2016-07-21,609081,Florida,1,2,3
55517,2015-01-27,285407,Louisiana,0,3,3
97087,2015-11-01,440632,California,2,1,3
189243,2017-05-25,851808,North Carolina,1,2,3
189260,2017-05-25,852580,Tennessee,1,2,3
5944,2014-02-11,105927,Louisiana,0,3,3
55356,2015-01-26,284816,Arizona,1,2,3
136589,2016-07-20,608451,New Jersey,1,2,3
231248,2018-02-03,1042191,Georgia,1,2,3
20983,2014-06-10,148603,Delaware,1,2,3
16297,2014-05-09,133704,California,0,3,3
55310,2015-01-26,284504,Minnesota,1,2,3
189375,2017-05-26,853105,Delaware,0,3,3
97174,2015-11-01,441087,South Carolina,0,3,3
97181,2015-11-01,440579,California,2,1,3
189415,2017-05-26,852258,Illinois,0,3,3
189417,2017-05-26,853227,Arkansas,3,0,3
135789,2016-07-16,605313,Alabama,1,2,3
191084,2017-06-03,858792,Missouri,2,1,3
134249,2016-07-06,596828,Maryland,0,3,3
193021,2017-06-15,868689,Illinois,0,3,3
192806,2017-06-14,866677,South Carolina,0,3,3
52461,2015-01-02,272869,Wisconsin,2,1,3
52424,2015-01-02,272739,Wisconsin,2,1,3
134647,2016-07-09,599153,Florida,2,1,3
238823,2018-03-25,1078312,Virginia,1,2,3
134616,2016-07-09,598901,Illinois,0,3,3
12045,2014-04-06,123235,Texas,3,0,3
99139,2015-11-15,447959,Illinois,1,2,3
192934,2017-06-15,868242,Alabama,2,1,3
99144,2015-11-15,448720,Georgia,0,3,3
5517,2014-02-07,105608,Ohio,1,2,3
52322,2015-01-01,272248,Texas,1,2,3
192968,2017-06-15,868533,Georgia,0,3,3
134565,2016-07-08,599239,Georgia,0,3,3
192975,2017-06-15,868339,Michigan,1,2,3
134557,2016-07-08,598877,Illinois,1,2,3
192982,2017-06-15,869000,Louisiana,2,1,3
134527,2016-07-08,599053,Mississippi,0,3,3
226447,2018-01-04,1020780,Missouri,0,3,3
192799,2017-06-14,867833,Georgia,0,3,3
52474,2015-01-03,273523,Oklahoma,3,0,3
52477,2015-01-03,273517,Alabama,0,3,3
98988,2015-11-14,447348,Tennessee,0,3,3
192499,2017-06-12,866149,California,2,1,3
134818,2016-07-10,599527,Florida,3,0,3
134809,2016-07-10,599322,Texas,1,2,3
192565,2017-06-12,865938,Michigan,0,3,3
52625,2015-01-04,274924,Pennsylvania,1,2,3
192583,2017-06-12,866020,Illinois,2,1,3
12025,2014-04-06,122746,Vermont,0,3,3
52611,2015-01-04,273800,California,3,0,3
192658,2017-06-13,877685,California,0,3,3
52478,2015-01-03,273735,Pennsylvania,3,0,3
192660,2017-06-13,866271,Nevada,3,0,3
98998,2015-11-14,448630,Mississippi,0,3,3
99004,2015-11-14,447599,Illinois,0,3,3
52532,2015-01-03,273153,Illinois,0,3,3
99046,2015-11-14,447786,North Carolina,1,2,3
52501,2015-01-03,273257,California,0,3,3
134707,2016-07-09,600242,West Virginia,0,3,3
52490,2015-01-03,273367,New Jersey,1,2,3
193012,2017-06-15,868194,Tennessee,3,0,3
52297,2015-01-01,272067,West Virginia,0,3,3
135739,2016-07-16,604689,Texas,0,3,3
5503,2014-02-07,106402,Colorado,3,0,3
99275,2015-11-16,449158,Ohio,1,2,3
12075,2014-04-06,122753,New York,0,3,3
16057,2014-05-07,133281,Kentucky,0,3,3
52079,2014-12-31,271962,Arizona,0,3,3
52062,2014-12-31,272126,North Carolina,0,3,3
134402,2016-07-07,599081,Louisiana,0,3,3
99298,2015-11-16,449136,Michigan,0,3,3
193489,2017-06-18,871044,Nevada,1,2,3
1630,2014-01-10,95015,Florida,1,2,3
99351,2015-11-16,449025,Louisiana,0,3,3
51859,2014-12-29,272151,Pennsylvania,1,2,3
134309,2016-07-06,596980,North Carolina,2,1,3
99380,2015-11-16,449063,Virginia,1,2,3
21373,2014-06-13,149684,Louisiana,0,3,3
238856,2018-03-26,1078366,Missouri,0,3,3
193588,2017-06-18,869909,Louisiana,3,0,3
226382,2018-01-04,1020788,Texas,0,3,3
99401,2015-11-17,448810,New York,0,3,3
193609,2017-06-18,869891,Virginia,1,2,3
52118,2014-12-31,271919,California,1,2,3
226400,2018-01-04,1022269,Kansas,3,0,3
193347,2017-06-17,869229,Illinois,0,3,3
193151,2017-06-16,869272,Indiana,2,1,3
52269,2015-01-01,272343,Ohio,0,3,3
193087,2017-06-15,868105,Ohio,2,1,3
193089,2017-06-15,868250,Kentucky,0,3,3
52268,2015-01-01,272935,New Jersey,0,3,3
12055,2014-04-06,122660,Missouri,1,2,3
52229,2015-01-01,272600,Washington,2,1,3
193134,2017-06-16,869222,Illinois,1,2,3
134513,2016-07-08,599033,California,3,0,3
193170,2017-06-16,869374,California,1,2,3
52147,2015-01-01,272097,North Carolina,1,2,3
193191,2017-06-16,868967,Mississippi,1,2,3
134490,2016-07-08,598960,Missouri,1,2,3
134474,2016-07-07,598115,Alabama,1,2,3
193240,2017-06-16,869330,District of Columbia,1,2,3
193262,2017-06-17,869455,Oklahoma,1,2,3
52174,2015-01-01,272281,Indiana,1,2,3
52158,2015-01-01,271979,California,1,2,3
193341,2017-06-17,869857,Illinois,0,3,3
98938,2015-11-13,447675,Maryland,3,0,3
192483,2017-06-12,865425,Kentucky,1,2,3
98917,2015-11-13,448215,Florida,0,3,3
52714,2015-01-05,274327,New York,0,3,3
53691,2015-01-13,278239,California,1,2,3
53669,2015-01-13,278227,Florida,2,1,3
231383,2018-02-05,1043120,Arizona,2,1,3
98213,2015-11-08,445944,Oklahoma,1,2,3
191555,2017-06-06,861415,California,0,3,3
98256,2015-11-09,444539,Ohio,0,3,3
98268,2015-11-09,444310,Kentucky,1,2,3
191578,2017-06-06,861364,Texas,2,1,3
191590,2017-06-06,861172,Pennsylvania,3,0,3
135441,2016-07-14,625564,Texas,3,0,3
98303,2015-11-09,444339,New York,1,2,3
135371,2016-07-13,603310,New Jersey,0,3,3
191703,2017-06-07,862745,Texas,0,3,3
53448,2015-01-11,278205,Alabama,0,3,3
191760,2017-06-07,861982,Maryland,1,2,3
53400,2015-01-11,277048,Oklahoma,0,3,3
53389,2015-01-11,276794,Pennsylvania,0,3,3
191773,2017-06-07,862301,Missouri,3,0,3
234568,2018-02-26,1057715,Minnesota,0,3,3
98195,2015-11-08,444527,Arizona,0,3,3
191435,2017-06-06,861827,Florida,0,3,3
5703,2014-02-09,106609,Louisiana,0,3,3
135683,2016-07-15,604979,California,0,3,3
234630,2018-02-27,1059516,Mississippi,0,3,3
191108,2017-06-04,859405,Massachusetts,2,1,3
191131,2017-06-04,859284,Illinois,0,3,3
21139,2014-06-11,145305,South Carolina,1,2,3
191143,2017-06-04,859959,Illinois,0,3,3
53929,2015-01-15,279147,District of Columbia,0,3,3
98056,2015-11-07,443629,Georgia,1,2,3
135711,2016-07-16,604193,Illinois,0,3,3
135662,2016-07-15,604048,District of Columbia,1,2,3
191395,2017-06-05,860630,Florida,0,3,3
135660,2016-07-15,604131,Pennsylvania,1,2,3
191254,2017-06-04,859837,Missouri,0,3,3
135628,2016-07-15,604140,Illinois,0,3,3
5715,2014-02-09,105520,California,2,1,3
191327,2017-06-05,861484,Michigan,0,3,3
191333,2017-06-05,860385,Indiana,1,2,3
53807,2015-01-14,278651,Florida,3,0,3
98138,2015-11-08,444592,Florida,0,3,3
53364,2015-01-10,276644,Georgia,1,2,3
53355,2015-01-10,276787,Pennsylvania,3,0,3
191841,2017-06-08,863333,Kentucky,1,2,3
21253,2014-06-12,145718,Ohio,0,3,3
192274,2017-06-11,864875,New York,0,3,3
52934,2015-01-06,274781,Illinois,2,1,3
98801,2015-11-12,447573,Florida,0,3,3
135055,2016-07-11,601243,Illinois,0,3,3
192298,2017-06-11,864825,Illinois,1,2,3
5598,2014-02-08,104804,Ohio,0,3,3
135001,2016-07-11,600082,Kansas,0,3,3
5595,2014-02-08,105258,Florida,2,1,3
231524,2018-02-06,1046208,Nevada,2,1,3
192226,2017-06-10,864484,Texas,0,3,3
192322,2017-06-11,865010,Florida,0,3,3
192323,2017-06-11,865029,Maryland,0,3,3
98849,2015-11-13,447682,Maryland,0,3,3
134944,2016-07-11,600905,Pennsylvania,1,2,3
52796,2015-01-05,274386,California,3,0,3
21264,2014-06-12,145489,Washington,0,3,3
234542,2018-02-26,1057956,Pennsylvania,1,2,3
52721,2015-01-05,274592,Tennessee,1,2,3
226617,2018-01-05,1021165,Ohio,0,3,3
135084,2016-07-11,600978,Texas,1,2,3
98455,2015-11-10,445501,Illinois,0,3,3
53157,2015-01-08,275405,Texas,3,0,3
53251,2015-01-09,277019,Nevada,0,3,3
135233,2016-07-12,601407,Virginia,0,3,3
53212,2015-01-09,276532,California,1,2,3
192024,2017-06-09,863826,New York,1,2,3
192032,2017-06-09,864238,New Jersey,2,1,3
135160,2016-07-12,601795,Ohio,0,3,3
53186,2015-01-09,276659,Pennsylvania,0,3,3
53164,2015-01-09,276231,Tennessee,1,2,3
53151,2015-01-08,276678,Texas,1,2,3
192216,2017-06-10,865043,Florida,0,3,3
238764,2018-03-25,1078897,South Carolina,3,0,3
192075,2017-06-09,867651,District of Columbia,0,3,3
226633,2018-01-06,1021930,Alabama,2,1,3
135136,2016-07-12,602607,Ohio,0,3,3
135135,2016-07-12,601021,Virginia,0,3,3
98695,2015-11-12,446745,California,2,1,3
135113,2016-07-12,601440,Florida,0,3,3
231484,2018-02-05,1043000,Florida,0,3,3
20079,2014-06-04,143163,Texas,1,2,3
235193,2018-03-02,1060772,Missouri,0,3,3
178341,2017-03-26,803422,Virginia,0,3,3
151169,2016-10-14,676395,Louisiana,1,2,3
18765,2014-05-26,139024,Illinois,0,3,3
75908,2015-06-20,360764,New Jersey,2,1,3
163099,2016-12-24,733154,Kansas,2,1,3
163108,2016-12-24,733350,Utah,1,2,3
163109,2016-12-24,733524,Alaska,2,1,3
228903,2018-01-20,1031342,Nevada,2,1,3
18768,2014-05-26,140040,New York,0,3,3
85036,2015-08-15,395566,South Carolina,0,3,3
85039,2015-08-15,396524,Virginia,1,2,3
163065,2016-12-24,733127,New York,0,3,3
75837,2015-06-19,360684,California,0,3,3
163242,2016-12-25,734343,Oregon,2,1,3
235794,2018-03-06,1064079,Illinois,0,3,3
163304,2016-12-25,734433,Michigan,0,3,3
75816,2015-06-19,360447,Ohio,2,1,3
18779,2014-05-26,139104,Ohio,1,2,3
151125,2016-10-14,676105,Louisiana,0,3,3
85106,2015-08-15,395376,Oregon,0,3,3
163074,2016-12-24,733492,Mississippi,2,1,3
75962,2015-06-20,361366,Georgia,1,2,3
164242,2016-12-30,738711,Texas,3,0,3
84934,2015-08-14,395112,Illinois,0,3,3
76144,2015-06-21,361715,New Jersey,0,3,3
9977,2014-03-20,116904,Texas,0,3,3
76139,2015-06-21,361533,California,1,2,3
162806,2016-12-22,732296,South Carolina,1,2,3
76124,2015-06-21,361520,Texas,2,1,3
76120,2015-06-21,361671,Michigan,0,3,3
8719,2014-03-10,113979,Alaska,2,1,3
162899,2016-12-23,733893,South Carolina,0,3,3
162934,2016-12-23,732289,California,1,2,3
151288,2016-10-15,676927,Florida,0,3,3
151332,2016-10-15,677487,California,2,1,3
76054,2015-06-21,361965,Tennessee,0,3,3
76044,2015-06-21,361664,Florida,3,0,3
76041,2015-06-21,361784,Louisiana,2,1,3
18751,2014-05-26,138951,Wisconsin,0,3,3
8704,2014-03-10,113713,Indiana,1,2,3
84982,2015-08-15,395086,Florida,0,3,3
76005,2015-06-20,361512,Illinois,0,3,3
85114,2015-08-16,396024,Louisiana,0,3,3
85130,2015-08-16,396836,Pennsylvania,0,3,3
163390,2016-12-26,734721,Illinois,0,3,3
85266,2015-08-16,395665,New Jersey,0,3,3
163791,2016-12-28,736438,Louisiana,1,2,3
163829,2016-12-28,735652,Texas,0,3,3
229954,2018-01-26,1036758,Texas,1,2,3
163858,2016-12-28,736721,Georgia,0,3,3
75337,2015-06-16,359524,Massachusetts,0,3,3
85239,2015-08-16,395727,Illinois,0,3,3
150820,2016-10-12,674416,Tennessee,0,3,3
163947,2016-12-29,738072,Illinois,0,3,3
150769,2016-10-12,674626,Ohio,0,3,3
8659,2014-03-09,113445,Tennessee,0,3,3
150756,2016-10-12,674681,Massachusetts,1,2,3
75181,2015-06-14,357962,Illinois,1,2,3
10057,2014-03-21,117183,South Carolina,2,1,3
150724,2016-10-12,675202,Illinois,0,3,3
75165,2015-06-14,357690,New York,0,3,3
75118,2015-06-14,357807,South Carolina,1,2,3
236959,2018-03-14,1069464,Alabama,2,1,3
85374,2015-08-17,396939,Illinois,0,3,3
85218,2015-08-16,396220,California,1,2,3
75480,2015-06-17,360204,Illinois,0,3,3
163758,2016-12-28,736485,Florida,1,2,3
150948,2016-10-13,676340,Illinois,0,3,3
75764,2015-06-19,360969,Florida,1,2,3
151055,2016-10-14,676109,Michigan,2,1,3
163478,2016-12-26,734589,Arizona,0,3,3
85162,2015-08-16,396107,New Jersey,3,0,3
75703,2015-06-18,360485,Illinois,1,2,3
75680,2015-06-18,360593,Indiana,1,2,3
163541,2016-12-27,735585,Louisiana,0,3,3
17685,2014-05-19,137116,Michigan,1,2,3
85166,2015-08-16,395794,Michigan,0,3,3
150992,2016-10-13,675009,California,3,0,3
163582,2016-12-27,735104,Louisiana,0,3,3
75644,2015-06-18,360508,Illinois,0,3,3
85185,2015-08-16,396649,Wisconsin,0,3,3
85186,2015-08-16,395784,North Carolina,0,3,3
163618,2016-12-27,736266,Missouri,1,2,3
75583,2015-06-17,359591,California,2,1,3
163716,2016-12-28,736258,Illinois,0,3,3
76158,2015-06-21,362910,New Mexico,0,3,3
151423,2016-10-16,677624,Arizona,1,2,3
84869,2015-08-14,395384,Wisconsin,1,2,3
84405,2015-08-11,392588,District of Columbia,0,3,3
84294,2015-08-10,391762,Michigan,0,3,3
161656,2016-12-14,726137,Indiana,0,3,3
76952,2015-06-27,365424,California,1,2,3
152181,2016-10-20,681768,Florida,3,0,3
236719,2018-03-12,1081985,New York,0,3,3
161718,2016-12-15,726568,Indiana,1,2,3
161727,2016-12-15,726663,Maryland,0,3,3
84401,2015-08-11,392388,California,1,2,3
152024,2016-10-19,680447,Florida,0,3,3
228946,2018-01-20,1031381,Wisconsin,2,1,3
76888,2015-06-26,364187,Tennessee,0,3,3
161810,2016-12-16,727323,Illinois,0,3,3
236723,2018-03-12,1068584,Maryland,0,3,3
161820,2016-12-16,728435,Arkansas,0,3,3
76882,2015-06-26,364645,Alaska,0,3,3
152009,2016-10-19,684886,Missouri,0,3,3
152002,2016-10-19,679812,Kentucky,0,3,3
84410,2015-08-11,393096,Indiana,0,3,3
76994,2015-06-27,364785,Michigan,3,0,3
161475,2016-12-13,726528,Arizona,3,0,3
76998,2015-06-27,365113,Michigan,0,3,3
152315,2016-10-20,681023,Louisiana,1,2,3
77288,2015-06-29,366216,New York,1,2,3
161151,2016-12-11,723863,Louisiana,2,1,3
161227,2016-12-12,724544,Nevada,0,3,3
8870,2014-03-11,113859,Florida,0,3,3
161239,2016-12-12,723766,Georgia,1,2,3
161252,2016-12-12,723852,Georgia,1,2,3
152418,2016-10-21,681388,Kentucky,0,3,3
77196,2015-06-28,365610,Louisiana,1,2,3
84204,2015-08-10,392290,Kansas,2,1,3
84216,2015-08-10,391450,Delaware,1,2,3
161315,2016-12-12,725505,Pennsylvania,0,3,3
152374,2016-10-21,681531,Pennsylvania,0,3,3
161319,2016-12-12,723812,Louisiana,0,3,3
77088,2015-06-28,365331,Alabama,3,0,3
152345,2016-10-21,681773,Georgia,0,3,3
161405,2016-12-13,725962,New Jersey,0,3,3
161457,2016-12-13,725548,Tennessee,1,2,3
84435,2015-08-11,393175,Florida,3,0,3
84450,2015-08-11,392770,Texas,1,2,3
76183,2015-06-21,361631,Michigan,0,3,3
162492,2016-12-20,730314,Texas,1,2,3
162334,2016-12-19,729725,New York,0,3,3
151626,2016-10-16,678089,Arizona,3,0,3
236738,2018-03-12,1068590,Maryland,0,3,3
76386,2015-06-23,362983,Illinois,1,2,3
76367,2015-06-23,362988,Illinois,0,3,3
162457,2016-12-20,731225,Arkansas,0,3,3
162470,2016-12-20,729692,Tennessee,0,3,3
18712,2014-05-26,147053,Illinois,1,2,3
151494,2016-10-16,677791,Missouri,1,2,3
151967,2016-10-19,679868,West Virginia,3,0,3
18716,2014-05-26,147014,Illinois,0,3,3
162560,2016-12-20,730355,Tennessee,1,2,3
76304,2015-06-22,362095,Texas,1,2,3
76263,2015-06-22,362453,Florida,0,3,3
84846,2015-08-14,395102,Illinois,0,3,3
151450,2016-10-16,677670,Georgia,0,3,3
162715,2016-12-21,731910,Oregon,2,1,3
18723,2014-05-26,139953,Louisiana,0,3,3
84706,2015-08-13,394851,Maryland,3,0,3
84671,2015-08-13,394264,New York,1,2,3
229794,2018-01-25,1035669,Florida,1,2,3
162229,2016-12-18,728364,Pennsylvania,1,2,3
161959,2016-12-17,728805,Michigan,3,0,3
84493,2015-08-12,394137,Missouri,1,2,3
84510,2015-08-12,393829,Massachusetts,2,1,3
84511,2015-08-12,393825,Massachusetts,1,2,3
84543,2015-08-12,394130,Missouri,0,3,3
8796,2014-03-11,113894,Alabama,0,3,3
18680,2014-05-26,140173,Louisiana,0,3,3
8791,2014-03-11,220197,Pennsylvania,1,2,3
18681,2014-05-26,139457,Florida,3,0,3
229789,2018-01-25,1035421,Arizona,0,3,3
162131,2016-12-17,728282,Mississippi,3,0,3
228923,2018-01-20,1032777,Ohio,0,3,3
9949,2014-03-20,117037,California,3,0,3
162206,2016-12-18,728927,Washington,1,2,3
76537,2015-06-24,363296,Illinois,2,1,3
162216,2016-12-18,728441,Illinois,0,3,3
84666,2015-08-13,393607,New York,1,2,3
85378,2015-08-17,396079,Florida,0,3,3
228772,2018-01-20,1031267,Mississippi,0,3,3
86907,2015-08-27,402674,Indiana,3,0,3
149472,2016-10-04,670155,Michigan,1,2,3
73777,2015-06-06,353187,District of Columbia,0,3,3
86318,2015-08-23,400250,North Carolina,0,3,3
17547,2014-05-18,136012,Wisconsin,2,1,3
73742,2015-06-06,353110,Florida,0,3,3
17546,2014-05-18,138598,Louisiana,0,3,3
19015,2014-05-28,140209,California,0,3,3
73737,2015-06-06,353899,Mississippi,1,2,3
86331,2015-08-23,400468,Illinois,0,3,3
149435,2016-10-03,669300,California,1,2,3
165855,2017-01-08,745905,Alabama,2,1,3
149403,2016-10-03,669063,Louisiana,1,2,3
86402,2015-08-24,400841,Pennsylvania,0,3,3
149379,2016-10-03,669098,Texas,0,3,3
86427,2015-08-24,400892,Tennessee,0,3,3
86478,2015-08-24,402508,New Jersey,0,3,3
166304,2017-01-11,748642,Delaware,0,3,3
166318,2017-01-11,748491,Mississippi,0,3,3
10228,2014-03-22,118660,Alabama,0,3,3
86299,2015-08-23,400222,New York,0,3,3
86292,2015-08-23,400689,Mississippi,1,2,3
150655,2016-10-11,675289,Virginia,0,3,3
165765,2017-01-07,745653,California,0,3,3
165628,2017-01-07,744977,Arizona,1,2,3
73951,2015-06-07,353371,Illinois,0,3,3
165645,2017-01-07,744863,Minnesota,1,2,3
165674,2017-01-07,744973,Ohio,2,1,3
235699,2018-03-06,1063770,Texas,2,1,3
73905,2015-06-07,354147,North Carolina,1,2,3
235696,2018-03-05,1062743,Missouri,3,0,3
73891,2015-06-07,353609,Utah,3,0,3
86212,2015-08-22,399494,Washington,1,2,3
165838,2017-01-08,745574,Texas,0,3,3
165783,2017-01-08,745332,Illinois,0,3,3
73875,2015-06-07,353574,Kentucky,2,1,3
86230,2015-08-23,400146,Ohio,1,2,3
73824,2015-06-06,353191,New York,1,2,3
86279,2015-08-23,400449,Indiana,1,2,3
149733,2016-10-05,670407,Oregon,3,0,3
149732,2016-10-05,670592,Colorado,0,3,3
165834,2017-01-08,745992,Michigan,2,1,3
228587,2018-01-18,1030347,California,0,3,3
166410,2017-01-12,749847,Texas,0,3,3
17518,2014-05-17,138313,Massachusetts,0,3,3
8286,2014-03-06,112935,Michigan,1,2,3
8301,2014-03-06,112856,Georgia,1,2,3
86831,2015-08-26,403100,California,1,2,3
166872,2017-01-14,750595,Georgia,0,3,3
148952,2016-09-30,668335,Mississippi,0,3,3
166904,2017-01-14,751267,Louisiana,0,3,3
148914,2016-09-30,667606,Texas,2,1,3
72825,2015-05-31,350051,South Carolina,0,3,3
148909,2016-09-30,666987,Arkansas,0,3,3
72796,2015-05-31,350652,Ohio,0,3,3
86549,2015-08-24,401126,Illinois,1,2,3
72792,2015-05-31,350667,Delaware,0,3,3
167038,2017-01-15,751818,Texas,0,3,3
19111,2014-05-28,139799,Georgia,1,2,3
72763,2015-05-30,350361,Texas,3,0,3
167115,2017-01-16,751858,Georgia,0,3,3
167129,2017-01-16,752772,New Jersey,3,0,3
72747,2015-05-30,349470,New York,1,2,3
148782,2016-09-29,665920,Florida,0,3,3
237175,2018-03-15,1070234,Texas,0,3,3
72935,2015-05-31,350217,Florida,2,1,3
166778,2017-01-14,750941,Minnesota,0,3,3
166773,2017-01-14,750765,Pennsylvania,0,3,3
86554,2015-08-24,401830,Georgia,1,2,3
166506,2017-01-12,749006,Florida,2,1,3
149243,2016-10-02,669109,California,1,2,3
149222,2016-10-02,668416,Tennessee,0,3,3
166617,2017-01-13,750040,California,3,0,3
73141,2015-06-02,352451,Pennsylvania,0,3,3
149148,2016-10-01,667155,North Carolina,0,3,3
149143,2016-10-01,667118,Texas,0,3,3
86717,2015-08-25,402061,Illinois,0,3,3
86735,2015-08-26,402899,Pennsylvania,0,3,3
149115,2016-10-01,667910,New Jersey,0,3,3
19077,2014-05-28,417745,Texas,3,0,3
73023,2015-06-01,350483,Tennessee,1,2,3
149078,2016-10-01,667175,Virginia,0,3,3
149053,2016-10-01,667066,Illinois,0,3,3
149048,2016-10-01,667601,Texas,1,2,3
149047,2016-10-01,668160,Tennessee,1,2,3
10170,2014-03-22,117475,North Carolina,0,3,3
86089,2015-08-22,399830,Texas,0,3,3
150004,2016-10-07,671834,Mississippi,0,3,3
8532,2014-03-08,114434,Colorado,1,2,3
164579,2017-01-01,739675,South Dakota,1,2,3
74808,2015-06-12,356790,Texas,2,1,3
164598,2017-01-01,740017,Missouri,0,3,3
164601,2017-01-01,739426,Illinois,0,3,3
150455,2016-10-10,673589,North Carolina,1,2,3
150454,2016-10-10,673389,Pennsylvania,1,2,3
235759,2018-03-06,1063882,Illinois,0,3,3
164623,2017-01-01,739962,Kansas,0,3,3
8531,2014-03-08,113198,Colorado,1,2,3
74673,2015-06-11,357305,North Carolina,0,3,3
164666,2017-01-01,739590,North Carolina,2,1,3
164675,2017-01-01,740027,Arkansas,0,3,3
150424,2016-10-10,673159,Ohio,0,3,3
18895,2014-05-27,140288,Louisiana,1,2,3
85702,2015-08-19,398756,Ohio,3,0,3
164718,2017-01-01,739378,Illinois,0,3,3
164723,2017-01-01,740315,Illinois,0,3,3
74688,2015-06-12,356566,Illinois,0,3,3
74907,2015-06-13,357156,Virginia,0,3,3
164501,2017-01-01,740386,Louisiana,3,0,3
74909,2015-06-13,357160,Virginia,1,2,3
164491,2017-01-01,740846,New Jersey,0,3,3
17644,2014-05-18,136461,Florida,0,3,3
164288,2016-12-31,739493,Oklahoma,0,3,3
236980,2018-03-14,1070270,Washington,2,1,3
150590,2016-10-11,674058,Texas,3,0,3
85465,2015-08-18,398029,Connecticut,0,3,3
150563,2016-10-11,674250,Illinois,0,3,3
150556,2016-10-11,674221,Illinois,0,3,3
18866,2014-05-27,139342,California,1,2,3
74974,2015-06-13,357933,Nevada,0,3,3
164414,2016-12-31,739691,Missouri,1,2,3
74973,2015-06-13,357604,Illinois,0,3,3
164428,2016-12-31,739979,Missouri,0,3,3
85483,2015-08-18,398207,Minnesota,0,3,3
150537,2016-10-10,673032,Michigan,2,1,3
74948,2015-06-13,358485,Louisiana,1,2,3
237042,2018-03-14,1069486,Florida,3,0,3
85509,2015-08-18,397533,District of Columbia,1,2,3
164745,2017-01-01,739413,Maryland,2,1,3
85763,2015-08-20,399905,Georgia,1,2,3
74070,2015-06-08,354361,Kentucky,0,3,3
165391,2017-01-05,743904,California,2,1,3
165255,2017-01-04,742606,Florida,1,2,3
85991,2015-08-21,398894,Illinois,1,2,3
150127,2016-10-08,671745,Indiana,1,2,3
150118,2016-10-08,672172,California,2,1,3
165301,2017-01-04,742854,California,1,2,3
150115,2016-10-08,672596,Missouri,0,3,3
150086,2016-10-08,676572,Alabama,0,3,3
150083,2016-10-08,672198,Illinois,0,3,3
86013,2015-08-21,399063,Ohio,0,3,3
150399,2016-10-10,673507,Illinois,0,3,3
165428,2017-01-05,743560,Arizona,2,1,3
10153,2014-03-22,117952,Connecticut,0,3,3
150035,2016-10-08,671926,California,2,1,3
150025,2016-10-07,671773,Florida,2,1,3
165505,2017-01-06,744305,Illinois,0,3,3
10159,2014-03-22,117376,Illinois,0,3,3
150006,2016-10-07,671260,South Carolina,3,0,3
86058,2015-08-22,400212,New York,1,2,3
235721,2018-03-06,1063439,Missouri,0,3,3
237123,2018-03-15,1070683,Ohio,0,3,3
165171,2017-01-03,741397,Arkansas,2,1,3
74337,2015-06-09,356016,Arizona,3,0,3
229963,2018-01-26,1036998,Virginia,1,2,3
237064,2018-03-14,1069566,North Carolina,3,0,3
74579,2015-06-11,356723,Georgia,1,2,3
150372,2016-10-09,672556,Alabama,1,2,3
164888,2017-01-02,741564,Florida,0,3,3
229971,2018-01-26,1036395,Ohio,0,3,3
150332,2016-10-09,672405,Maryland,1,2,3
74539,2015-06-10,355688,New York,0,3,3
17610,2014-05-18,136356,Illinois,0,3,3
18919,2014-05-27,139895,Kansas,2,1,3
10120,2014-03-22,135133,Florida,3,0,3
165052,2017-01-03,741536,Illinois,2,1,3
74443,2015-06-10,355952,Pennsylvania,0,3,3
74441,2015-06-10,355931,New Jersey,0,3,3
150296,2016-10-09,672944,Maryland,0,3,3
150285,2016-10-09,673609,Arkansas,1,2,3
229973,2018-01-26,1036244,Maryland,1,2,3
235853,2018-03-07,1064500,Alabama,1,2,3
161133,2016-12-11,723331,Kentucky,0,3,3
84117,2015-08-09,391476,California,0,3,3
154329,2016-11-01,691312,Georgia,1,2,3
157442,2016-11-20,705373,South Carolina,0,3,3
157452,2016-11-20,705533,Texas,1,2,3
229505,2018-01-24,1035349,Georgia,1,2,3
157518,2016-11-20,706163,Illinois,0,3,3
236400,2018-03-10,1066875,Florida,3,0,3
9639,2014-03-18,116147,Florida,3,0,3
157556,2016-11-20,708926,Alabama,2,1,3
18311,2014-05-23,138471,Missouri,0,3,3
157625,2016-11-21,708066,Texas,0,3,3
236384,2018-03-10,1070026,Louisiana,0,3,3
79747,2015-07-14,374448,Illinois,0,3,3
79737,2015-07-14,374206,Washington,3,0,3
157664,2016-11-21,707371,Arkansas,0,3,3
9253,2014-03-15,115308,Georgia,0,3,3
157711,2016-11-21,707073,Ohio,0,3,3
157743,2016-11-22,708378,Florida,0,3,3
229209,2018-01-22,1059381,California,0,3,3
157752,2016-11-22,708279,Illinois,0,3,3
82584,2015-07-31,387808,Iowa,0,3,3
18005,2014-05-21,137180,Illinois,0,3,3
84108,2015-08-09,391331,New York,0,3,3
154620,2016-11-03,691992,Mississippi,0,3,3
157195,2016-11-18,704076,Georgia,3,0,3
9317,2014-03-15,115251,Virginia,1,2,3
157210,2016-11-18,704015,California,0,3,3
80194,2015-07-17,376647,North Carolina,0,3,3
80157,2015-07-17,376920,Maryland,3,0,3
157276,2016-11-19,704796,Florida,0,3,3
80152,2015-07-17,377486,Washington,2,1,3
80146,2015-07-17,378267,Texas,1,2,3
154619,2016-11-03,692497,Georgia,0,3,3
157409,2016-11-19,706433,Virginia,0,3,3
9302,2014-03-15,115051,Illinois,0,3,3
82451,2015-07-30,385630,Missouri,2,1,3
82484,2015-07-31,386363,Colorado,1,2,3
80047,2015-07-16,374989,Texas,0,3,3
157373,2016-11-19,705737,California,1,2,3
157400,2016-11-19,704923,Michigan,0,3,3
157403,2016-11-19,705881,Oklahoma,2,1,3
157407,2016-11-19,704909,Pennsylvania,3,0,3
79695,2015-07-14,376118,Ohio,3,0,3
236409,2018-03-10,1066994,Michigan,0,3,3
79685,2015-07-14,373878,Florida,1,2,3
79339,2015-07-12,373594,North Carolina,1,2,3
79433,2015-07-12,373944,Florida,0,3,3
158220,2016-11-25,710344,New Jersey,1,2,3
17961,2014-05-20,138362,Georgia,1,2,3
229172,2018-01-22,1033199,Texas,1,2,3
158258,2016-11-25,710212,Illinois,2,1,3
79400,2015-07-12,373127,Texas,1,2,3
158266,2016-11-25,710113,California,1,2,3
79360,2015-07-12,372775,Michigan,0,3,3
79322,2015-07-12,372752,Illinois,2,1,3
82685,2015-08-01,387011,California,1,2,3
18374,2014-05-24,205072,Texas,2,1,3
154016,2016-10-30,688754,Kentucky,0,3,3
79296,2015-07-12,373413,California,1,2,3
158413,2016-11-26,711631,Illinois,0,3,3
158415,2016-11-26,710872,Alabama,0,3,3
17951,2014-05-20,137281,North Carolina,0,3,3
82897,2015-08-02,386461,Louisiana,3,0,3
79267,2015-07-11,374045,Indiana,0,3,3
9205,2014-03-14,115016,New York,1,2,3
82825,2015-08-02,385907,New York,1,2,3
9209,2014-03-14,115172,California,0,3,3
236452,2018-03-11,1067671,Georgia,1,2,3
157811,2016-11-22,708369,Florida,1,2,3
154257,2016-11-01,691341,Louisiana,0,3,3
82701,2015-08-01,386720,Tennessee,2,1,3
157847,2016-11-22,708417,California,3,0,3
157911,2016-11-23,709730,Pennsylvania,0,3,3
79609,2015-07-13,374004,California,0,3,3
154215,2016-10-31,689768,Texas,0,3,3
229200,2018-01-22,1032564,South Carolina,0,3,3
154187,2016-10-31,690269,Nevada,0,3,3
79566,2015-07-13,373785,Texas,2,1,3
9223,2014-03-14,115165,California,1,2,3
82766,2015-08-01,385488,Ohio,0,3,3
82793,2015-08-01,385370,New York,0,3,3
158071,2016-11-24,711145,South Carolina,0,3,3
82797,2015-08-01,385203,Illinois,1,2,3
158076,2016-11-24,709410,New York,1,2,3
79472,2015-07-12,373173,Texas,1,2,3
80240,2015-07-17,376823,District of Columbia,1,2,3
80283,2015-07-17,376641,Ohio,0,3,3
236318,2018-03-10,1067104,Oklahoma,2,1,3
81063,2015-07-22,381220,Maryland,0,3,3
81213,2015-07-23,380574,California,3,0,3
81768,2015-07-26,382161,Michigan,0,3,3
156090,2016-11-12,699412,South Carolina,1,2,3
81186,2015-07-23,380586,California,0,3,3
81140,2015-07-22,381233,Maryland,0,3,3
81825,2015-07-26,382189,Louisiana,0,3,3
156160,2016-11-12,699394,Mississippi,2,1,3
81097,2015-07-22,384850,Alabama,1,2,3
81865,2015-07-27,384542,New Mexico,1,2,3
155285,2016-11-06,694817,Alabama,0,3,3
81012,2015-07-22,379522,Massachusetts,0,3,3
81002,2015-07-22,379323,Louisiana,0,3,3
155330,2016-11-07,695249,Pennsylvania,0,3,3
236239,2018-03-09,1065766,California,0,3,3
155315,2016-11-07,695704,Pennsylvania,0,3,3
156288,2016-11-13,700132,Virginia,0,3,3
229228,2018-01-22,1033627,Utah,0,3,3
80903,2015-07-21,379821,Nevada,0,3,3
81216,2015-07-23,380977,New York,0,3,3
229291,2018-01-22,1032816,New Jersey,2,1,3
18095,2014-05-21,139415,Maryland,0,3,3
81753,2015-07-26,381842,Illinois,2,1,3
155788,2016-11-10,697532,Illinois,1,2,3
229329,2018-01-23,1034522,Florida,2,1,3
81556,2015-07-25,381543,South Carolina,0,3,3
81640,2015-07-25,381316,Illinois,1,2,3
9499,2014-03-17,117242,Florida,3,0,3
236190,2018-03-09,1066562,District of Columbia,0,3,3
229355,2018-01-23,1043824,Alabama,0,3,3
81545,2015-07-25,381960,California,0,3,3
81531,2015-07-25,381560,South Carolina,1,2,3
155911,2016-11-11,698016,Maryland,1,2,3
155579,2016-11-08,696589,New Jersey,0,3,3
81466,2015-07-24,381591,South Carolina,0,3,3
155546,2016-11-08,696408,Idaho,2,1,3
155520,2016-11-08,696365,Alabama,0,3,3
155477,2016-11-08,696534,Louisiana,0,3,3
236175,2018-03-09,1066733,California,1,2,3
156016,2016-11-11,698361,Colorado,0,3,3
80855,2015-07-21,379286,Louisiana,1,2,3
80827,2015-07-20,378009,Ohio,0,3,3
157109,2016-11-18,704399,Virginia,1,2,3
154896,2016-11-04,692733,New York,2,1,3
9362,2014-03-16,115403,Ohio,0,3,3
18236,2014-05-23,757793,Louisiana,1,2,3
82169,2015-07-29,383756,Montana,2,1,3
154941,2016-11-05,693327,North Carolina,0,3,3
80430,2015-07-18,376718,California,1,2,3
80424,2015-07-18,376468,California,2,1,3
154918,2016-11-05,693892,Missouri,3,0,3
82190,2015-07-29,385256,District of Columbia,0,3,3
9349,2014-03-15,115652,California,0,3,3
155266,2016-11-06,694591,Alabama,1,2,3
154883,2016-11-04,693938,South Carolina,3,0,3
156934,2016-11-17,702900,Florida,0,3,3
9346,2014-03-15,115681,South Carolina,1,2,3
154873,2016-11-04,693900,Illinois,0,3,3
157004,2016-11-17,702679,Virginia,0,3,3
82288,2015-07-30,385348,New York,0,3,3
82293,2015-07-30,384061,Washington,1,2,3
80374,2015-07-18,376403,Illinois,3,0,3
80469,2015-07-19,377706,Louisiana,0,3,3
80470,2015-07-19,378162,Massachusetts,0,3,3
155079,2016-11-05,693519,Maryland,1,2,3
18058,2014-05-21,143803,Maryland,0,3,3
81956,2015-07-27,382352,Michigan,1,2,3
81972,2015-07-27,382855,Massachusetts,0,3,3
80696,2015-07-20,378649,Georgia,1,2,3
80651,2015-07-19,377830,Louisiana,0,3,3
156462,2016-11-14,700741,Texas,0,3,3
80631,2015-07-19,377496,Texas,1,2,3
156504,2016-11-14,700468,Texas,1,2,3
156506,2016-11-14,700320,Illinois,0,3,3
80630,2015-07-19,377598,Colorado,1,2,3
155246,2016-11-06,694320,New York,0,3,3
156522,2016-11-14,699592,New York,0,3,3
155193,2016-11-06,694100,Georgia,2,1,3
156596,2016-11-15,701133,Florida,0,3,3
156616,2016-11-15,701118,Florida,0,3,3
156624,2016-11-15,701359,Pennsylvania,1,2,3
155131,2016-11-06,694072,Indiana,1,2,3
80515,2015-07-19,378780,Colorado,1,2,3
158444,2016-11-26,711933,Florida,2,1,3
82905,2015-08-02,387103,South Carolina,0,3,3
158472,2016-11-26,711022,Florida,1,2,3
153254,2016-10-26,685400,Louisiana,1,2,3
160011,2016-12-04,718323,Maryland,3,0,3
83534,2015-08-06,390459,Oklahoma,0,3,3
160020,2016-12-05,718507,Florida,1,2,3
229035,2018-01-21,1032238,New York,0,3,3
8988,2014-03-12,114174,Tennessee,1,2,3
160144,2016-12-05,719228,Alaska,0,3,3
18517,2014-05-25,139005,Georgia,0,3,3
78070,2015-07-04,368808,California,0,3,3
160242,2016-12-06,719660,Missouri,1,2,3
153116,2016-10-25,685492,South Carolina,0,3,3
77994,2015-07-04,368061,West Virginia,0,3,3
8975,2014-03-12,183511,North Carolina,3,0,3
160254,2016-12-06,720312,Florida,0,3,3
153158,2016-10-25,685162,Missouri,2,1,3
77975,2015-07-03,367785,Indiana,0,3,3
153141,2016-10-25,684953,Florida,1,2,3
236614,2018-03-12,1068150,Florida,2,1,3
153139,2016-10-25,685713,Florida,3,0,3
159999,2016-12-04,718032,North Carolina,0,3,3
159997,2016-12-04,718581,Illinois,0,3,3
78116,2015-07-04,369372,Maine,3,0,3
153342,2016-10-26,685771,Florida,0,3,3
78265,2015-07-05,369055,Ohio,1,2,3
159766,2016-12-03,717977,Michigan,0,3,3
83421,2015-08-05,388674,New York,0,3,3
83433,2015-08-05,388154,Florida,0,3,3
83460,2015-08-05,388472,Georgia,0,3,3
159821,2016-12-03,717434,Illinois,0,3,3
153457,2016-10-27,687045,Texas,0,3,3
153456,2016-10-27,686469,North Carolina,2,1,3
83491,2015-08-05,388762,New York,0,3,3
159895,2016-12-04,717888,Illinois,1,2,3
9790,2014-03-19,116909,Colorado,0,3,3
78179,2015-07-04,368364,Illinois,0,3,3
153391,2016-10-27,686957,Tennessee,1,2,3
153379,2016-10-27,687299,Illinois,0,3,3
78156,2015-07-04,368571,Tennessee,0,3,3
159943,2016-12-04,718564,Illinois,0,3,3
78129,2015-07-04,369094,New York,1,2,3
83619,2015-08-06,389106,Georgia,2,1,3
160346,2016-12-07,863540,California,0,3,3
153516,2016-10-28,687746,Louisiana,1,2,3
152643,2016-10-22,682548,Florida,1,2,3
77575,2015-07-01,369657,Maine,3,0,3
77552,2015-07-01,367313,Iowa,0,3,3
152678,2016-10-23,682684,Washington,1,2,3
160911,2016-12-10,724617,California,1,2,3
83953,2015-08-08,391171,Pennsylvania,1,2,3
83967,2015-08-08,391556,California,0,3,3
18589,2014-05-25,139162,California,0,3,3
160958,2016-12-10,722768,Illinois,1,2,3
160976,2016-12-10,723488,California,1,2,3
160358,2016-12-07,720596,Tennessee,1,2,3
18592,2014-05-25,139077,Michigan,0,3,3
83991,2015-08-08,390385,Washington,0,3,3
152635,2016-10-22,682693,Florida,0,3,3
84032,2015-08-09,390910,Texas,3,0,3
84049,2015-08-09,391798,Florida,1,2,3
84054,2015-08-09,395860,Kansas,3,0,3
77370,2015-06-29,366264,Washington,0,3,3
17810,2014-05-19,137794,Connecticut,0,3,3
229719,2018-01-25,1035462,Louisiana,2,1,3
152702,2016-10-23,682917,Nevada,1,2,3
77603,2015-07-01,367385,Maryland,0,3,3
160780,2016-12-09,722869,Utah,2,1,3
18537,2014-05-25,138852,Illinois,0,3,3
160469,2016-12-07,720296,Georgia,3,0,3
77836,2015-07-02,367473,Michigan,0,3,3
153028,2016-10-25,684926,California,1,2,3
83714,2015-08-07,390491,Pennsylvania,1,2,3
77791,2015-07-02,368057,Texas,1,2,3
160524,2016-12-08,721399,Virginia,3,0,3
83746,2015-08-07,389822,Kansas,1,2,3
9832,2014-03-19,116513,Florida,2,1,3
77721,2015-07-02,367796,California,2,1,3
83828,2015-08-08,390960,North Carolina,3,0,3
83846,2015-08-08,390407,Oregon,1,2,3
83857,2015-08-08,817705,Michigan,1,2,3
83863,2015-08-08,391179,Utah,0,3,3
77656,2015-07-01,367278,Illinois,0,3,3
152840,2016-10-24,683634,Illinois,0,3,3
83893,2015-08-08,390810,Michigan,0,3,3
78274,2015-07-05,369177,Florida,1,2,3
153549,2016-10-28,687557,California,0,3,3
158488,2016-11-26,711059,North Carolina,1,2,3
158804,2016-11-28,712705,California,1,2,3
158712,2016-11-27,712101,California,0,3,3
235964,2018-03-07,1064346,Pennsylvania,0,3,3
229126,2018-01-21,1032276,California,0,3,3
158729,2016-11-27,711845,Texas,1,2,3
153906,2016-10-30,688690,New York,0,3,3
153905,2016-10-30,688833,New York,0,3,3
158773,2016-11-27,712012,New York,0,3,3
229120,2018-01-21,1032229,Kentucky,0,3,3
18417,2014-05-24,140772,South Carolina,0,3,3
78671,2015-07-07,369911,Pennsylvania,1,2,3
158857,2016-11-28,713455,California,1,2,3
153890,2016-10-30,688944,Kansas,3,0,3
83041,2015-08-03,389185,Missouri,0,3,3
158867,2016-11-28,713138,Illinois,1,2,3
158873,2016-11-28,713245,Illinois,1,2,3
158885,2016-11-28,713292,Florida,0,3,3
153860,2016-10-30,689235,Alabama,0,3,3
158898,2016-11-28,713144,Illinois,0,3,3
158700,2016-11-27,711923,Kentucky,0,3,3
79010,2015-07-10,373071,Minnesota,0,3,3
153937,2016-10-30,688620,Illinois,0,3,3
153943,2016-10-30,688995,Oklahoma,0,3,3
79225,2015-07-11,372874,California,1,2,3
153989,2016-10-30,688899,Texas,0,3,3
229556,2018-01-24,1037690,California,0,3,3
158538,2016-11-26,712008,Maine,2,1,3
158541,2016-11-26,711175,Pennsylvania,1,2,3
82918,2015-08-02,401751,Illinois,0,3,3
79173,2015-07-11,373101,Missouri,0,3,3
158575,2016-11-27,711814,Colorado,0,3,3
79158,2015-07-11,372125,Illinois,1,2,3
153971,2016-10-30,688698,Pennsylvania,1,2,3
158614,2016-11-27,712393,Louisiana,2,1,3
158626,2016-11-27,712651,Tennessee,2,1,3
236009,2018-03-08,1066600,Ohio,1,2,3
229560,2018-01-24,1034452,Michigan,1,2,3
82945,2015-08-02,385920,Michigan,0,3,3
79075,2015-07-10,371842,Tennessee,0,3,3
18400,2014-05-24,138481,Missouri,0,3,3
153845,2016-10-30,689225,Mississippi,0,3,3
158985,2016-11-29,714671,Illinois,0,3,3
159727,2016-12-03,718068,Florida,0,3,3
78381,2015-07-05,369668,Minnesota,0,3,3
159332,2016-12-01,716208,Georgia,0,3,3
159352,2016-12-01,716012,Ohio,0,3,3
159366,2016-12-01,715969,Arizona,1,2,3
153699,2016-10-29,688071,Tennessee,2,1,3
153694,2016-10-29,688546,Alabama,1,2,3
9060,2014-03-13,114563,Louisiana,2,1,3
78418,2015-07-06,369699,California,0,3,3
78385,2015-07-05,369677,Minnesota,0,3,3
78373,2015-07-05,372103,Alabama,0,3,3
153831,2016-10-29,687995,Massachusetts,0,3,3
159543,2016-12-02,717540,Florida,0,3,3
78358,2015-07-05,368761,Illinois,1,2,3
159580,2016-12-02,717492,Tennessee,0,3,3
159615,2016-12-02,716774,West Virginia,0,3,3
83332,2015-08-04,387911,Indiana,0,3,3
236485,2018-03-11,1067437,Florida,2,1,3
78336,2015-07-05,370055,Florida,0,3,3
153574,2016-10-28,687269,Michigan,3,0,3
18450,2014-05-24,140344,Florida,2,1,3
159306,2016-11-30,715855,Colorado,0,3,3
83169,2015-08-03,387148,Georgia,1,2,3
159263,2016-11-30,715859,California,0,3,3
153824,2016-10-29,689051,Texas,1,2,3
158992,2016-11-29,714495,Texas,1,2,3
153818,2016-10-29,688172,Illinois,0,3,3
9100,2014-03-13,114851,California,3,0,3
153813,2016-10-29,688627,Colorado,2,1,3
159071,2016-11-29,716185,Colorado,3,0,3
159090,2016-11-29,714447,Maryland,0,3,3
159114,2016-11-29,714413,Missouri,0,3,3
153790,2016-10-29,688661,Michigan,0,3,3
159121,2016-11-29,714176,Ohio,2,1,3
159123,2016-11-29,714741,Texas,1,2,3
159135,2016-11-30,715392,Pennsylvania,0,3,3
78573,2015-07-07,371046,South Carolina,0,3,3
83164,2015-08-03,386858,Massachusetts,0,3,3
78550,2015-07-07,369788,Texas,1,2,3
18443,2014-05-24,143052,Florida,1,2,3
153748,2016-10-29,688067,Arizona,1,2,3
72742,2015-05-30,349404,Illinois,0,3,3
72721,2015-05-30,352351,Missouri,0,3,3
92233,2015-09-29,422371,Georgia,0,3,3
66815,2015-04-23,329111,Oklahoma,1,2,3
67034,2015-04-25,329471,Pennsylvania,1,2,3
230470,2018-01-29,1038476,Georgia,0,3,3
66994,2015-04-24,329115,Ohio,1,2,3
66955,2015-04-24,329280,Illinois,1,2,3
66934,2015-04-24,330775,Florida,2,1,3
90452,2015-09-18,416564,Utah,3,0,3
90481,2015-09-18,416520,Illinois,0,3,3
66822,2015-04-23,328582,Florida,2,1,3
66749,2015-04-23,328779,Georgia,3,0,3
90362,2015-09-17,415692,California,3,0,3
66740,2015-04-23,328721,Oklahoma,1,2,3
90545,2015-09-18,416569,Georgia,2,1,3
66666,2015-04-22,328578,Florida,1,2,3
174857,2017-03-04,787817,Oklahoma,1,2,3
144219,2016-09-01,645198,Illinois,0,3,3
90574,2015-09-19,417024,Connecticut,2,1,3
174905,2017-03-04,788009,California,0,3,3
90582,2015-09-19,417252,North Carolina,2,1,3
67083,2015-04-25,329545,Oregon,0,3,3
174520,2017-03-02,786869,Nevada,1,2,3
66143,2015-04-18,327356,Alabama,0,3,3
90258,2015-09-17,415722,Illinois,0,3,3
67367,2015-04-27,330973,New York,1,2,3
144621,2016-09-04,648164,Maryland,1,2,3
174171,2017-02-28,784871,Texas,1,2,3
174180,2017-02-28,786128,Alabama,1,2,3
174184,2017-02-28,785058,Ohio,0,3,3
174196,2017-02-28,879667,California,1,2,3
174214,2017-02-28,784576,Texas,3,0,3
90246,2015-09-17,415974,Nevada,1,2,3
174291,2017-02-28,784732,Florida,1,2,3
174493,2017-03-02,786390,Texas,3,0,3
90260,2015-09-17,415805,Florida,2,1,3
144578,2016-09-04,648132,Florida,1,2,3
144546,2016-09-03,647546,Maryland,0,3,3
144519,2016-09-03,646989,Missouri,1,2,3
174421,2017-03-01,785914,Texas,1,2,3
144507,2016-09-03,647122,Michigan,0,3,3
10782,2014-03-27,119333,Louisiana,1,2,3
144493,2016-09-03,647657,Connecticut,0,3,3
174934,2017-03-05,788046,South Carolina,1,2,3
90610,2015-09-19,418623,Mississippi,1,2,3
144153,2016-09-01,645022,Delaware,0,3,3
227741,2018-01-13,1026687,Minnesota,0,3,3
66259,2015-04-18,325219,North Carolina,0,3,3
175437,2017-03-08,789955,Texas,2,1,3
66240,2015-04-18,327259,Missouri,0,3,3
143899,2016-08-31,643928,Nevada,0,3,3
66231,2015-04-18,325530,New York,0,3,3
19828,2014-06-02,145727,Texas,3,0,3
90743,2015-09-20,417552,Missouri,0,3,3
90751,2015-09-20,418288,Washington,0,3,3
143884,2016-08-31,645248,California,0,3,3
66539,2015-04-20,326029,Illinois,0,3,3
90755,2015-09-20,417937,New York,3,0,3
19833,2014-06-02,151388,Colorado,0,3,3
66212,2015-04-18,325516,Delaware,0,3,3
90776,2015-09-20,416927,Missouri,1,2,3
7376,2014-02-25,110167,Arkansas,1,2,3
143858,2016-08-30,643456,Georgia,3,0,3
175601,2017-03-09,791209,Wisconsin,0,3,3
143839,2016-08-30,643481,Pennsylvania,0,3,3
1478,2014-01-09,94597,Ohio,2,1,3
143959,2016-08-31,644089,New York,1,2,3
66281,2015-04-19,326237,Florida,0,3,3
143975,2016-08-31,643947,California,1,2,3
90623,2015-09-19,417391,South Carolina,1,2,3
144144,2016-09-01,646572,New York,1,2,3
10827,2014-03-27,119481,Georgia,0,3,3
144131,2016-09-01,645796,South Carolina,1,2,3
66381,2015-04-19,325990,Texas,0,3,3
175108,2017-03-06,788845,New York,0,3,3
66352,2015-04-19,325787,Illinois,0,3,3
66339,2015-04-19,325791,Illinois,0,3,3
66336,2015-04-19,325687,Connecticut,1,2,3
66327,2015-04-19,325837,Pennsylvania,3,0,3
19808,2014-06-02,142851,Virginia,0,3,3
66320,2015-04-19,325805,California,0,3,3
90688,2015-09-19,416459,Ohio,3,0,3
17027,2014-05-14,135037,California,1,2,3
143978,2016-08-31,645351,New Jersey,1,2,3
66292,2015-04-19,326806,Nevada,3,0,3
175271,2017-03-07,789494,Florida,0,3,3
227832,2018-01-13,1027203,Oregon,1,2,3
67393,2015-04-27,331252,Virginia,0,3,3
90193,2015-09-16,415089,Pennsylvania,0,3,3
68208,2015-05-02,335108,California,1,2,3
173223,2017-02-22,781166,Florida,3,0,3
89601,2015-09-12,412452,Virginia,1,2,3
89641,2015-09-13,413341,Texas,0,3,3
19634,2014-06-01,142056,Illinois,0,3,3
237588,2018-03-18,1072356,Pennsylvania,1,2,3
173327,2017-02-22,780921,Kansas,1,2,3
478,2014-01-01,182940,Michigan,1,2,3
145026,2016-09-06,649155,North Carolina,2,1,3
19643,2014-06-01,151392,California,0,3,3
173461,2017-02-23,781662,District of Columbia,1,2,3
173404,2017-02-23,781094,Michigan,0,3,3
144975,2016-09-05,648147,Florida,3,0,3
68131,2015-05-02,334228,South Carolina,0,3,3
173420,2017-02-23,781573,Oklahoma,0,3,3
173434,2017-02-23,781681,Maryland,0,3,3
89704,2015-09-13,413733,Virginia,0,3,3
173438,2017-02-23,782492,Louisiana,1,2,3
173441,2017-02-23,781583,Texas,2,1,3
68300,2015-05-03,334083,California,0,3,3
10690,2014-03-26,119001,Indiana,1,2,3
68321,2015-05-03,333848,Texas,1,2,3
89587,2015-09-12,416501,Michigan,2,1,3
68640,2015-05-05,334690,New York,1,2,3
68631,2015-05-05,335176,Maryland,0,3,3
68601,2015-05-05,335132,California,0,3,3
68573,2015-05-05,334834,Louisiana,0,3,3
172851,2017-02-19,778040,Michigan,1,2,3
68533,2015-05-04,335553,Virginia,0,3,3
145293,2016-09-07,650760,Texas,0,3,3
89526,2015-09-12,413309,Wisconsin,0,3,3
145258,2016-09-07,651661,Missouri,0,3,3
89546,2015-09-12,412953,Pennsylvania,0,3,3
89564,2015-09-12,412726,Georgia,2,1,3
68397,2015-05-04,335442,Alabama,3,0,3
68377,2015-05-03,333783,Maryland,0,3,3
173031,2017-02-20,779001,Pennsylvania,0,3,3
68367,2015-05-03,333637,Texas,2,1,3
145168,2016-09-07,650146,North Carolina,1,2,3
227897,2018-01-14,1027920,Indiana,1,2,3
144953,2016-09-05,648160,Maryland,0,3,3
173471,2017-02-23,781677,Maryland,0,3,3
144631,2016-09-04,648290,Texas,0,3,3
173860,2017-02-26,783767,California,1,2,3
89875,2015-09-14,414062,Illinois,0,3,3
89914,2015-09-14,413540,Mississippi,3,0,3
173778,2017-02-25,782654,Florida,1,2,3
67707,2015-04-29,332023,Pennsylvania,0,3,3
67692,2015-04-29,332218,New York,1,2,3
173813,2017-02-25,782873,Illinois,2,1,3
173825,2017-02-25,782939,Kentucky,0,3,3
173841,2017-02-25,782880,Illinois,0,3,3
67512,2015-04-28,330878,California,1,2,3
144940,2016-09-05,648799,California,1,2,3
90034,2015-09-15,415861,Alabama,0,3,3
90058,2015-09-15,414696,Illinois,0,3,3
67489,2015-04-28,331225,Missouri,0,3,3
90129,2015-09-16,489753,Pennsylvania,0,3,3
144717,2016-09-04,647627,Alaska,1,2,3
174006,2017-02-27,784380,North Carolina,0,3,3
144639,2016-09-04,648660,Virginia,2,1,3
67421,2015-04-27,330129,Florida,0,3,3
173761,2017-02-25,782951,Illinois,0,3,3
144829,2016-09-05,649049,Illinois,0,3,3
227868,2018-01-13,1026302,Illinois,0,3,3
144834,2016-09-05,649257,Ohio,1,2,3
144932,2016-09-05,648236,North Carolina,1,2,3
68042,2015-05-01,333104,California,3,0,3
173516,2017-02-23,1007413,California,2,1,3
68034,2015-05-01,333402,Maryland,0,3,3
68022,2015-05-01,333026,Illinois,2,1,3
237591,2018-03-18,1072593,Nevada,0,3,3
89760,2015-09-13,413464,Texas,0,3,3
235318,2018-03-03,1061898,Illinois,3,0,3
144902,2016-09-05,648173,Tennessee,2,1,3
173614,2017-02-24,782917,North Carolina,1,2,3
89768,2015-09-13,413605,Illinois,0,3,3
173627,2017-02-24,782896,Florida,3,0,3
89769,2015-09-13,424187,California,3,0,3
235311,2018-03-03,1061465,Utah,1,2,3
144840,2016-09-05,648679,Kansas,0,3,3
237592,2018-03-18,1072115,South Carolina,0,3,3
144837,2016-09-05,647964,Maryland,1,2,3
175640,2017-03-09,791015,Florida,0,3,3
175696,2017-03-10,792367,Florida,0,3,3
167197,2017-01-16,751998,Oklahoma,3,0,3
177604,2017-03-22,800868,Georgia,1,2,3
227606,2018-01-12,1025683,District of Columbia,1,2,3
142935,2016-08-26,639216,West Virginia,1,2,3
227604,2018-01-12,1026860,California,1,2,3
91796,2015-09-26,420654,Florida,0,3,3
64518,2015-04-07,320002,South Carolina,1,2,3
177566,2017-03-22,800976,Georgia,1,2,3
91821,2015-09-26,420388,Tennessee,3,0,3
10992,2014-03-28,120027,North Carolina,2,1,3
142880,2016-08-25,639002,Arizona,2,1,3
91733,2015-09-26,420443,Texas,1,2,3
64392,2015-04-06,318689,Virginia,0,3,3
177679,2017-03-23,801226,Florida,0,3,3
142877,2016-08-25,638723,Illinois,0,3,3
91834,2015-09-26,420801,District of Columbia,2,1,3
20008,2014-06-03,142827,Virginia,0,3,3
227587,2018-01-12,1025949,Oklahoma,1,2,3
64377,2015-04-06,318527,New Jersey,1,2,3
177739,2017-03-23,801438,California,3,0,3
16917,2014-05-13,134749,California,0,3,3
64714,2015-04-08,320503,California,1,2,3
90801,2015-09-20,417927,California,0,3,3
64992,2015-04-10,322305,Maryland,3,0,3
176960,2017-03-19,797954,Illinois,0,3,3
235203,2018-03-02,1061246,Texas,1,2,3
91459,2015-09-24,421842,Arkansas,1,2,3
143187,2016-08-27,640136,Illinois,1,2,3
91616,2015-09-25,420284,Pennsylvania,2,1,3
1489,2014-01-09,94592,North Carolina,0,3,3
91621,2015-09-25,419951,Texas,1,2,3
143173,2016-08-27,640524,California,2,1,3
64966,2015-04-10,321189,North Carolina,0,3,3
177425,2017-03-21,799140,Louisiana,0,3,3
64928,2015-04-10,321689,Oregon,2,1,3
143161,2016-08-27,640038,Illinois,0,3,3
131297,2016-06-18,583204,Kentucky,3,0,3
177214,2017-03-20,799578,Missouri,2,1,3
91664,2015-09-25,419937,Tennessee,0,3,3
10969,2014-03-28,119692,Utah,1,2,3
230664,2018-01-31,1040466,Illinois,0,3,3
143061,2016-08-26,639762,Ohio,0,3,3
227577,2018-01-12,1027094,Ohio,0,3,3
7152,2014-02-23,110069,Colorado,3,0,3
91911,2015-09-27,420928,Ohio,1,2,3
227530,2018-01-11,1030301,Alabama,1,2,3
92053,2015-09-27,421110,New Jersey,1,2,3
64062,2015-04-04,317725,Missouri,1,2,3
64057,2015-04-04,317738,North Carolina,0,3,3
178119,2017-03-25,802841,Indiana,0,3,3
235163,2018-03-02,1061289,Georgia,0,3,3
178205,2017-03-26,803840,Louisiana,0,3,3
178211,2017-03-26,808057,Texas,1,2,3
92120,2015-09-28,422376,Pennsylvania,0,3,3
178240,2017-03-26,803339,Missouri,2,1,3
64271,2015-04-06,319170,Connecticut,0,3,3
178249,2017-03-26,803243,Illinois,1,2,3
142370,2016-08-22,635873,Texas,3,0,3
178294,2017-03-26,803582,New Jersey,0,3,3
92230,2015-09-29,423008,Georgia,0,3,3
142309,2016-08-22,636958,Wisconsin,0,3,3
178306,2017-03-26,803990,Maryland,1,2,3
235136,2018-03-02,1061770,Pennsylvania,2,1,3
178320,2017-03-26,803938,Connecticut,0,3,3
92051,2015-09-27,421830,Iowa,0,3,3
92043,2015-09-27,421867,Missouri,0,3,3
64088,2015-04-04,317989,Ohio,1,2,3
64116,2015-04-05,319455,Oklahoma,0,3,3
177892,2017-03-24,802484,California,1,2,3
91956,2015-09-27,420860,Illinois,0,3,3
20024,2014-06-03,143213,Texas,3,0,3
64225,2015-04-05,317951,Ohio,0,3,3
64210,2015-04-05,318056,Massachusetts,0,3,3
7137,2014-02-23,109775,California,0,3,3
64202,2015-04-05,318320,California,2,1,3
177964,2017-03-24,802875,Texas,0,3,3
177966,2017-03-24,802691,Kansas,0,3,3
227560,2018-01-11,1024687,New York,3,0,3
64200,2015-04-05,318805,North Carolina,1,2,3
142646,2016-08-24,638105,Kentucky,1,2,3
142633,2016-08-24,638116,Ohio,0,3,3
178009,2017-03-25,804395,Texas,2,1,3
237899,2018-03-20,1073488,Maryland,2,1,3
64169,2015-04-05,318433,New Jersey,1,2,3
64141,2015-04-05,318166,Wisconsin,2,1,3
235205,2018-03-02,1061369,Florida,3,0,3
91348,2015-09-23,419036,California,0,3,3
65169,2015-04-12,322253,Florida,1,2,3
90915,2015-09-20,416946,Alabama,0,3,3
175976,2017-03-12,792852,Oklahoma,2,1,3
143636,2016-08-29,642077,Wisconsin,1,2,3
7329,2014-02-24,109873,Alabama,0,3,3
19870,2014-06-02,143203,Texas,3,0,3
143627,2016-08-29,642534,North Carolina,0,3,3
176030,2017-03-12,794797,Minnesota,0,3,3
176032,2017-03-12,794393,Texas,0,3,3
7323,2014-02-24,109727,Alabama,0,3,3
176072,2017-03-12,792645,Illinois,2,1,3
1485,2014-01-09,95027,Florida,0,3,3
143614,2016-08-29,641978,Tennessee,0,3,3
90929,2015-09-21,417558,Ohio,0,3,3
176099,2017-03-13,794052,Louisiana,0,3,3
176104,2017-03-13,794942,Nebraska,0,3,3
65807,2015-04-16,324249,California,0,3,3
176164,2017-03-13,793224,California,3,0,3
176175,2017-03-13,794115,Illinois,3,0,3
176181,2017-03-13,793875,Nevada,1,2,3
143666,2016-08-29,641428,Pennsylvania,0,3,3
65953,2015-04-17,336091,Michigan,3,0,3
90891,2015-09-20,417333,Illinois,0,3,3
65976,2015-04-17,325874,Washington,2,1,3
143793,2016-08-30,643392,Wisconsin,1,2,3
175724,2017-03-10,791945,Illinois,2,1,3
143778,2016-08-30,643410,Minnesota,1,2,3
227716,2018-01-12,1025840,Kentucky,3,0,3
143749,2016-08-30,643209,Ohio,2,1,3
90850,2015-09-20,417496,California,0,3,3
175816,2017-03-11,792760,Arkansas,0,3,3
175827,2017-03-11,793060,Tennessee,1,2,3
175834,2017-03-11,792559,Ohio,1,2,3
7350,2014-02-24,109849,Minnesota,2,1,3
66064,2015-04-17,325757,Illinois,0,3,3
90855,2015-09-20,417659,Florida,0,3,3
7346,2014-02-24,111710,New York,3,0,3
175883,2017-03-11,792403,Pennsylvania,2,1,3
65987,2015-04-17,328695,Montana,0,3,3
19860,2014-06-02,142674,Oklahoma,1,2,3
175925,2017-03-11,792356,New York,0,3,3
90990,2015-09-21,418151,Indiana,1,2,3
143548,2016-08-29,643066,Connecticut,0,3,3
176868,2017-03-18,798043,California,0,3,3
65272,2015-04-12,322049,Alabama,3,0,3
143375,2016-08-28,641758,California,2,1,3
10926,2014-03-28,119646,New York,2,1,3
143365,2016-08-28,641199,Illinois,1,2,3
19922,2014-06-03,145365,Alabama,0,3,3
176713,2017-03-17,796442,Georgia,0,3,3
143351,2016-08-28,641871,New Mexico,3,0,3
65345,2015-04-13,323021,Georgia,3,0,3
65293,2015-04-12,329592,Florida,2,1,3
91245,2015-09-23,418872,Illinois,0,3,3
91059,2015-09-22,418464,Colorado,2,1,3
65249,2015-04-12,321981,Virginia,0,3,3
143291,2016-08-28,640611,Illinois,0,3,3
176816,2017-03-18,797388,Louisiana,3,0,3
19935,2014-06-03,149641,Michigan,0,3,3
65224,2015-04-12,322411,Tennessee,0,3,3
65205,2015-04-12,321863,Ohio,0,3,3
65196,2015-04-12,321927,Indiana,1,2,3
176854,2017-03-18,797119,Ohio,0,3,3
91197,2015-09-22,418484,Texas,3,0,3
65436,2015-04-13,322510,Louisiana,0,3,3
143412,2016-08-28,640590,Illinois,0,3,3
65461,2015-04-13,323357,Wisconsin,1,2,3
91068,2015-09-22,417710,North Carolina,1,2,3
176268,2017-03-14,794426,Tennessee,0,3,3
91084,2015-09-22,418386,South Carolina,2,1,3
91089,2015-09-22,418028,Alabama,2,1,3
230626,2018-01-30,1039600,Maryland,1,2,3
176426,2017-03-15,795094,Texas,1,2,3
65547,2015-04-14,323498,Florida,0,3,3
230631,2018-01-30,1040201,Texas,1,2,3
176446,2017-03-15,795069,Michigan,0,3,3
143427,2016-08-28,642118,Georgia,0,3,3
65539,2015-04-14,325978,Texas,2,1,3
65501,2015-04-14,322927,Tennessee,2,1,3
65478,2015-04-13,322237,Arizona,0,3,3
143424,2016-08-28,640562,Illinois,1,2,3
65474,2015-04-13,322856,California,0,3,3
176571,2017-03-16,795749,New York,0,3,3
176599,2017-03-16,795763,New York,0,3,3
68692,2015-05-06,336172,Alaska,0,3,3
172743,2017-02-19,777976,New York,0,3,3
172738,2017-02-19,778314,California,2,1,3
87691,2015-09-01,405904,Ohio,2,1,3
169087,2017-01-28,762456,South Carolina,1,2,3
87623,2015-08-31,405949,Minnesota,1,2,3
147884,2016-09-24,663342,New Jersey,0,3,3
230177,2018-01-27,1037459,Missouri,1,2,3
71638,2015-05-24,345761,Missouri,0,3,3
169146,2017-01-28,762972,Oklahoma,3,0,3
71631,2015-05-24,345715,Indiana,2,1,3
87649,2015-09-01,406704,North Carolina,1,2,3
169202,2017-01-28,761952,Illinois,0,3,3
147938,2016-09-24,661996,Louisiana,0,3,3
87702,2015-09-01,407371,Missouri,1,2,3
71597,2015-05-24,346149,Georgia,0,3,3
169245,2017-01-29,763007,Ohio,2,1,3
169257,2017-01-29,762711,Wisconsin,0,3,3
19268,2014-05-29,140608,Illinois,1,2,3
87732,2015-09-01,407824,Maryland,0,3,3
147666,2016-09-22,660856,Tennessee,3,0,3
87735,2015-09-01,405127,Ohio,0,3,3
147935,2016-09-24,665706,California,3,0,3
71674,2015-05-24,345606,Illinois,1,2,3
172735,2017-02-19,778192,California,2,1,3
168878,2017-01-27,762247,Maryland,0,3,3
71821,2015-05-25,346931,California,0,3,3
168759,2017-01-26,761471,Alabama,3,0,3
148061,2016-09-25,663571,Virginia,0,3,3
148039,2016-09-25,662940,District of Columbia,0,3,3
168802,2017-01-26,761837,Missouri,3,0,3
17397,2014-05-17,138354,California,0,3,3
71724,2015-05-24,346089,Virginia,1,2,3
87572,2015-08-31,404434,Illinois,0,3,3
168881,2017-01-27,761778,Virginia,3,0,3
71678,2015-05-24,346072,New York,0,3,3
168895,2017-01-27,762130,Missouri,1,2,3
87576,2015-08-31,404578,Ohio,0,3,3
148007,2016-09-24,662434,Alabama,0,3,3
168921,2017-01-27,807278,Louisiana,1,2,3
147986,2016-09-24,663560,Mississippi,0,3,3
168991,2017-01-27,761727,South Carolina,0,3,3
19244,2014-05-29,140578,Illinois,1,2,3
169037,2017-01-28,763053,Illinois,0,3,3
71528,2015-05-23,345570,California,3,0,3
71520,2015-05-23,345949,Texas,2,1,3
71519,2015-05-23,345857,Arizona,1,2,3
147214,2016-09-19,658324,Mississippi,1,2,3
87886,2015-09-02,406698,North Carolina,1,2,3
71163,2015-05-21,344221,Florida,0,3,3
169659,2017-01-31,764694,North Carolina,0,3,3
8008,2014-03-03,111726,New Jersey,2,1,3
169661,2017-01-31,765323,Colorado,0,3,3
8006,2014-03-03,113871,Maryland,1,2,3
169754,2017-02-01,766108,Minnesota,1,2,3
169758,2017-02-01,766268,North Carolina,1,2,3
87971,2015-09-02,406923,Illinois,1,2,3
169349,2017-01-29,763628,New Jersey,3,0,3
147192,2016-09-19,658714,Illinois,0,3,3
169815,2017-02-01,765870,Illinois,2,1,3
87974,2015-09-02,424178,New York,0,3,3
147176,2016-09-19,658335,New Jersey,0,3,3
71033,2015-05-20,343567,California,0,3,3
147153,2016-09-19,658651,Pennsylvania,0,3,3
71007,2015-05-20,343601,California,1,2,3
71006,2015-05-20,344424,Tennessee,0,3,3
230185,2018-01-28,1037581,Colorado,2,1,3
19308,2014-05-30,142489,Alabama,0,3,3
169604,2017-01-31,765658,New Mexico,1,2,3
87863,2015-09-02,406119,Louisiana,0,3,3
71507,2015-05-23,345139,Florida,1,2,3
147579,2016-09-21,660224,Kentucky,0,3,3
147571,2016-09-21,660151,Alaska,1,2,3
71487,2015-05-23,345831,Wisconsin,0,3,3
71470,2015-05-23,347555,New York,0,3,3
87790,2015-09-01,406159,Illinois,1,2,3
147548,2016-09-21,659663,Michigan,2,1,3
147526,2016-09-21,660105,Maryland,0,3,3
147495,2016-09-21,660558,Alabama,1,2,3
147491,2016-09-21,660507,Illinois,0,3,3
87832,2015-09-02,406305,Illinois,1,2,3
147488,2016-09-21,660485,Illinois,0,3,3
71306,2015-05-22,345389,Illinois,0,3,3
19297,2014-05-30,142296,California,3,0,3
19298,2014-05-30,141604,Georgia,1,2,3
71289,2015-05-22,345274,Michigan,1,2,3
71281,2015-05-22,345406,Maryland,1,2,3
148113,2016-09-25,663097,Illinois,1,2,3
71864,2015-05-25,347584,Minnesota,1,2,3
10372,2014-03-23,174148,California,1,2,3
148535,2016-09-28,666118,Ohio,0,3,3
148573,2016-09-28,665811,Alabama,0,3,3
167665,2017-01-18,755189,Nevada,2,1,3
167682,2017-01-19,755680,Tennessee,0,3,3
72496,2015-05-29,349882,Colorado,1,2,3
72469,2015-05-29,349219,Pennsylvania,3,0,3
72460,2015-05-29,349677,Wisconsin,0,3,3
167808,2017-01-19,756036,Washington,0,3,3
87128,2015-08-28,403679,California,0,3,3
72426,2015-05-28,348633,Illinois,0,3,3
148482,2016-09-27,665277,Ohio,0,3,3
1405,2014-01-09,94585,Tennessee,0,3,3
517,2014-01-02,92883,Florida,1,2,3
19158,2014-05-29,144627,Illinois,3,0,3
148526,2016-09-28,664802,Louisiana,3,0,3
167929,2017-01-20,756610,Tennessee,1,2,3
167932,2017-01-20,755581,Louisiana,3,0,3
8207,2014-03-05,115288,Massachusetts,0,3,3
167934,2017-01-20,756350,Illinois,0,3,3
167652,2017-01-18,754343,North Carolina,0,3,3
148576,2016-09-28,666390,Illinois,0,3,3
167633,2017-01-18,754588,South Carolina,2,1,3
148590,2016-09-28,665716,Maryland,3,0,3
167230,2017-01-16,752317,Florida,1,2,3
167237,2017-01-16,992231,Virginia,1,2,3
228471,2018-01-17,1030282,Texas,3,0,3
17469,2014-05-17,168563,New York,0,3,3
72703,2015-05-30,350207,Florida,2,1,3
167269,2017-01-16,752391,Idaho,0,3,3
167289,2017-01-16,755530,California,1,2,3
72670,2015-05-30,349392,New York,1,2,3
87012,2015-08-28,403981,District of Columbia,2,1,3
167339,2017-01-17,753744,Illinois,1,2,3
167373,2017-01-17,753617,Utah,0,3,3
87053,2015-08-28,403791,Indiana,0,3,3
148631,2016-09-28,665587,Georgia,1,2,3
72578,2015-05-29,348732,Florida,1,2,3
72573,2015-05-29,349423,Illinois,0,3,3
87086,2015-08-28,403490,Georgia,2,1,3
10312,2014-03-23,117748,Illinois,0,3,3
167976,2017-01-20,756112,Alabama,0,3,3
168029,2017-01-21,756888,Illinois,0,3,3
168683,2017-01-25,760457,Florida,0,3,3
168502,2017-01-23,757765,Indiana,1,2,3
168333,2017-01-22,757594,Texas,1,2,3
168366,2017-01-23,757933,Georgia,2,1,3
681,2014-01-03,93219,Texas,1,2,3
72094,2015-05-26,347771,Pennsylvania,0,3,3
168399,2017-01-23,758748,Kentucky,1,2,3
87384,2015-08-30,404991,Virginia,0,3,3
168431,2017-01-23,757848,Indiana,1,2,3
72027,2015-05-26,346613,North Dakota,2,1,3
71984,2015-05-26,346920,California,2,1,3
168047,2017-01-21,756364,Illinois,1,2,3
71980,2015-05-26,348801,Washington,3,0,3
168531,2017-01-25,760351,District of Columbia,0,3,3
71931,2015-05-25,346797,New York,0,3,3
71898,2015-05-25,346011,Maryland,1,2,3
87473,2015-08-30,404064,Missouri,1,2,3
148128,2016-09-25,663734,California,0,3,3
228362,2018-01-17,1031255,Wisconsin,0,3,3
168677,2017-01-25,760423,Mississippi,1,2,3
168330,2017-01-22,756974,Illinois,0,3,3
72119,2015-05-26,346834,California,1,2,3
228363,2018-01-17,1029742,California,1,2,3
228379,2018-01-17,1029803,Oklahoma,1,2,3
148455,2016-09-27,664586,Texas,3,0,3
228429,2018-01-17,1028929,Kentucky,0,3,3
168092,2017-01-21,756497,Tennessee,0,3,3
8190,2014-03-05,112982,Alabama,0,3,3
72319,2015-05-28,349131,Oregon,0,3,3
168104,2017-01-21,756368,Illinois,1,2,3
168117,2017-01-21,756941,Illinois,0,3,3
72279,2015-05-27,348094,Pennsylvania,2,1,3
87241,2015-08-29,403841,Massachusetts,1,2,3
168195,2017-01-22,757070,Illinois,0,3,3
148299,2016-09-26,663941,Pennsylvania,1,2,3
168219,2017-01-22,757697,Louisiana,3,0,3
87261,2015-08-29,403897,Tennessee,0,3,3
72203,2015-05-27,348884,South Carolina,0,3,3
168266,2017-01-22,757235,North Carolina,0,3,3
168289,2017-01-22,758169,Texas,1,2,3
235567,2018-03-05,1062792,Idaho,1,2,3
230196,2018-01-28,1038230,Tennessee,1,2,3
17336,2014-05-16,137286,California,3,0,3
169925,2017-02-02,766801,Florida,0,3,3
145927,2016-09-11,653648,California,1,2,3
171654,2017-02-12,774309,California,1,2,3
171663,2017-02-12,773790,Mississippi,2,1,3
7783,2014-03-01,111142,South Carolina,1,2,3
171670,2017-02-12,772829,California,0,3,3
230329,2018-01-28,1037509,New York,1,2,3
19494,2014-05-31,141762,New York,0,3,3
69448,2015-05-10,338466,New York,0,3,3
230331,2018-01-28,1043164,Arkansas,0,3,3
19500,2014-05-31,141503,Kansas,1,2,3
89038,2015-09-09,410812,Maryland,1,2,3
19501,2014-05-31,142011,New Jersey,0,3,3
145896,2016-09-11,652937,New Jersey,2,1,3
69363,2015-05-10,337831,Texas,3,0,3
171895,2017-02-14,774567,Illinois,2,1,3
88952,2015-09-08,416027,Missouri,3,0,3
19512,2014-05-31,141660,Louisiana,3,0,3
235414,2018-03-04,1062504,Illinois,0,3,3
89014,2015-09-09,410918,Maryland,1,2,3
88829,2015-09-07,409828,New Mexico,3,0,3
88811,2015-09-07,410502,Missouri,0,3,3
69593,2015-05-11,338512,Illinois,0,3,3
146034,2016-09-12,654175,Arkansas,0,3,3
88623,2015-09-06,408667,Illinois,0,3,3
69865,2015-05-13,340708,Missouri,0,3,3
171429,2017-02-11,772298,South Carolina,0,3,3
171440,2017-02-11,772532,Michigan,1,2,3
146165,2016-09-13,654859,Louisiana,0,3,3
1440,2014-01-09,94613,South Carolina,1,2,3
69742,2015-05-12,340414,New Jersey,1,2,3
146125,2016-09-13,655918,New Jersey,0,3,3
69732,2015-05-12,338741,Louisiana,2,1,3
171524,2017-02-12,772793,Ohio,1,2,3
228095,2018-01-15,1027679,Louisiana,1,2,3
171540,2017-02-12,773135,North Carolina,3,0,3
69713,2015-05-12,339416,Michigan,0,3,3
146080,2016-09-12,653876,Maryland,3,0,3
10575,2014-03-25,119056,North Carolina,1,2,3
171596,2017-02-12,772854,South Carolina,0,3,3
146037,2016-09-12,654706,Michigan,1,2,3
7754,2014-03-01,112046,New Jersey,1,2,3
228051,2018-01-15,1027947,Texas,0,3,3
69877,2015-05-13,340181,Illinois,3,0,3
89388,2015-09-11,412851,Illinois,0,3,3
172440,2017-02-17,777249,Georgia,2,1,3
172497,2017-02-18,777660,Florida,1,2,3
145497,2016-09-09,652572,Michigan,0,3,3
172538,2017-02-18,778306,California,1,2,3
484,2014-01-01,92148,New York,0,3,3
172562,2017-02-18,778404,Ohio,2,1,3
145473,2016-09-09,652016,Pennsylvania,0,3,3
172611,2017-02-18,781141,Georgia,0,3,3
145445,2016-09-08,652028,Pennsylvania,0,3,3
145809,2016-09-11,653554,Florida,0,3,3
68773,2015-05-06,335193,Pennsylvania,1,2,3
68762,2015-05-06,337731,Missouri,0,3,3
68758,2015-05-06,335710,Missouri,1,2,3
172657,2017-02-18,777360,Illinois,1,2,3
145410,2016-09-08,650750,Texas,1,2,3
68722,2015-05-06,335234,Ohio,0,3,3
68703,2015-05-06,336934,Montana,3,0,3
68701,2015-05-06,335703,Missouri,0,3,3
68940,2015-05-07,336637,Virginia,1,2,3
172411,2017-02-17,777136,Utah,1,2,3
89315,2015-09-11,412977,Alabama,2,1,3
89291,2015-09-10,412034,Pennsylvania,1,2,3
228035,2018-01-14,1027694,North Carolina,0,3,3
145800,2016-09-11,653282,Illinois,1,2,3
69224,2015-05-09,337212,Ohio,0,3,3
69196,2015-05-09,337327,Ohio,0,3,3
69188,2015-05-09,338242,Virginia,1,2,3
69164,2015-05-09,340114,Ohio,0,3,3
89163,2015-09-09,410756,Louisiana,1,2,3
145712,2016-09-10,654566,Texas,3,0,3
228010,2018-01-14,1027343,Alaska,0,3,3
145657,2016-09-10,652231,Pennsylvania,0,3,3
69064,2015-05-08,337176,Michigan,1,2,3
172287,2017-02-16,776297,Virginia,3,0,3
145643,2016-09-10,652222,Virginia,1,2,3
172304,2017-02-16,776370,Maryland,0,3,3
69044,2015-05-08,336766,Virginia,1,2,3
145634,2016-09-10,652401,Ohio,0,3,3
145627,2016-09-10,652193,Missouri,2,1,3
19454,2014-05-31,141338,Tennessee,0,3,3
146263,2016-09-13,654599,Pennsylvania,0,3,3
230235,2018-01-28,1039552,North Carolina,2,1,3
170394,2017-02-05,768540,Florida,1,2,3
70573,2015-05-17,342770,Alabama,0,3,3
70569,2015-05-17,341846,Ohio,1,2,3
7939,2014-03-03,202488,Oklahoma,3,0,3
170337,2017-02-04,767862,Florida,1,2,3
170340,2017-02-04,767544,Maryland,1,2,3
70547,2015-05-17,342280,North Carolina,0,3,3
146923,2016-09-17,657161,North Carolina,0,3,3
70492,2015-05-17,342491,Pennsylvania,2,1,3
70477,2015-05-17,342089,California,0,3,3
70344,2015-05-16,341976,Missouri,0,3,3
146883,2016-09-17,660866,Michigan,0,3,3
146847,2016-09-17,657619,Louisiana,0,3,3
88326,2015-09-05,408253,North Carolina,2,1,3
237438,2018-03-17,1074298,Mississippi,0,3,3
10506,2014-03-25,121485,Georgia,2,1,3
228183,2018-01-15,1028109,Illinois,0,3,3
146773,2016-09-17,658463,North Carolina,0,3,3
170573,2017-02-06,768418,Louisiana,0,3,3
70618,2015-05-17,343199,Florida,1,2,3
70626,2015-05-17,342458,Colorado,0,3,3
88253,2015-09-04,407515,California,1,2,3
170261,2017-02-04,767523,Michigan,3,0,3
88063,2015-09-03,408322,Michigan,0,3,3
70901,2015-05-19,343551,Florida,0,3,3
147030,2016-09-18,659181,Florida,0,3,3
88085,2015-09-03,407291,California,1,2,3
170028,2017-02-02,767891,Alabama,1,2,3
88149,2015-09-04,407426,Illinois,0,3,3
70798,2015-05-19,343070,North Carolina,3,0,3
170162,2017-02-03,766879,Kentucky,2,1,3
70753,2015-05-18,343849,Oklahoma,0,3,3
170205,2017-02-04,767541,Maryland,1,2,3
88205,2015-09-04,408084,Illinois,1,2,3
70719,2015-05-18,343272,Florida,1,2,3
88217,2015-09-04,408690,District of Columbia,1,2,3
170225,2017-02-04,768456,Ohio,2,1,3
88221,2015-09-04,409352,Virginia,0,3,3
146938,2016-09-17,657215,Massachusetts,1,2,3
88246,2015-09-04,408156,Illinois,0,3,3
230285,2018-01-28,1038336,Oklahoma,0,3,3
70336,2015-05-16,341458,Ohio,1,2,3
171360,2017-02-11,772546,California,1,2,3
146290,2016-09-14,655383,Virginia,0,3,3
170993,2017-02-08,770737,Texas,0,3,3
170996,2017-02-08,769980,Alabama,2,1,3
88525,2015-09-06,409689,Mississippi,1,2,3
171041,2017-02-09,771273,Texas,3,0,3
171044,2017-02-09,771934,California,0,3,3
146412,2016-09-14,655359,Alabama,1,2,3
69983,2015-05-14,339805,Louisiana,3,0,3
88592,2015-09-06,408694,Tennessee,0,3,3
171244,2017-02-10,772503,Georgia,2,1,3
88428,2015-09-05,408168,Illinois,0,3,3
228117,2018-01-15,1028524,Washington,1,2,3
19449,2014-05-31,142534,Nebraska,0,3,3
171271,2017-02-10,782256,Alaska,0,3,3
171272,2017-02-10,772584,Iowa,0,3,3
171286,2017-02-10,772173,Maryland,2,1,3
171307,2017-02-10,771772,Florida,0,3,3
171340,2017-02-11,772944,Florida,1,2,3
171341,2017-02-11,773048,Florida,2,1,3
170986,2017-02-08,770626,Alabama,1,2,3
70111,2015-05-14,341146,New York,0,3,3
170961,2017-02-08,771572,Georgia,0,3,3
170925,2017-02-08,770273,Maryland,0,3,3
19405,2014-05-30,145410,California,3,0,3
170643,2017-02-06,769275,Ohio,0,3,3
146653,2016-09-16,657908,Missouri,1,2,3
70286,2015-05-16,342420,North Carolina,0,3,3
228139,2018-01-15,1027405,Texas,1,2,3
88454,2015-09-05,408671,California,0,3,3
1433,2014-01-09,94574,Florida,0,3,3
170686,2017-02-07,769076,Texas,0,3,3
170711,2017-02-07,769991,Oklahoma,3,0,3
70275,2015-05-16,341351,Massachusetts,0,3,3
88487,2015-09-06,409367,Virginia,0,3,3
10532,2014-03-25,118954,Maryland,1,2,3
146546,2016-09-15,656884,New Jersey,1,2,3
70165,2015-05-15,341969,Illinois,1,2,3
228124,2018-01-15,1028212,California,0,3,3
70145,2015-05-15,340958,Illinois,0,3,3
7873,2014-03-02,111398,North Carolina,0,3,3
102288,2015-12-08,463225,Mississippi,3,0,3
81607,2015-07-25,381298,Wisconsin,0,3,3
47390,2014-11-23,224135,New Jersey,1,2,3
41353,2014-10-12,205137,New York,0,3,3
219368,2017-11-19,991665,Nevada,0,3,3
210515,2017-09-26,942292,South Dakota,3,0,3
41287,2014-10-11,204374,Massachusetts,0,3,3
113529,2016-02-24,510795,Florida,0,3,3
120906,2016-04-12,539895,Oregon,2,1,3
219404,2017-11-19,991824,Michigan,2,1,3
113530,2016-02-24,512179,Indiana,3,0,3
219418,2017-11-19,991767,Indiana,2,1,3
210525,2017-09-26,942715,Maryland,0,3,3
31020,2014-08-11,173841,New Jersey,0,3,3
41343,2014-10-12,205153,Missouri,0,3,3
210530,2017-09-26,942073,Pennsylvania,1,2,3
219501,2017-11-19,991583,Colorado,1,2,3
41357,2014-10-12,205046,New Jersey,1,2,3
118462,2016-03-27,641967,Ohio,0,3,3
111542,2016-02-10,502862,Maryland,3,0,3
28003,2014-07-24,162963,Pennsylvania,1,2,3
120918,2016-04-12,539491,Ohio,0,3,3
35848,2014-09-08,195014,Maryland,1,2,3
41387,2014-10-12,204467,Virginia,2,1,3
35842,2014-09-08,187360,Michigan,1,2,3
41408,2014-10-12,205013,North Carolina,0,3,3
219490,2017-11-19,992321,Tennessee,0,3,3
105672,2015-12-31,476872,Indiana,0,3,3
205102,2017-08-23,918951,Minnesota,0,3,3
127302,2016-05-23,564787,Wisconsin,0,3,3
205123,2017-08-23,921931,Nebraska,0,3,3
41275,2014-10-11,204230,California,1,2,3
41157,2014-10-11,204366,Pennsylvania,0,3,3
41176,2014-10-11,204022,Washington,1,2,3
127227,2016-05-22,563613,Florida,0,3,3
23787,2014-06-29,152645,Texas,0,3,3
210459,2017-09-26,942991,Alabama,0,3,3
215662,2017-10-27,974997,Wisconsin,3,0,3
41209,2014-10-11,204455,South Carolina,0,3,3
127238,2016-05-22,563499,Massachusetts,2,1,3
111556,2016-02-10,503274,Alabama,2,1,3
105774,2016-01-01,476512,Virginia,0,3,3
127248,2016-05-22,563723,Ohio,0,3,3
210467,2017-09-26,943788,South Carolina,1,2,3
127262,2016-05-22,563435,Illinois,0,3,3
105753,2016-01-01,476839,Texas,0,3,3
123967,2016-05-01,551098,Wisconsin,2,1,3
35897,2014-09-09,188599,Louisiana,0,3,3
219337,2017-11-19,991728,Pennsylvania,0,3,3
113435,2016-02-23,510590,Texas,2,1,3
30957,2014-08-10,172614,Missouri,1,2,3
127274,2016-05-22,563730,Tennessee,1,2,3
105734,2016-01-01,476454,Florida,2,1,3
205164,2017-08-23,919779,Illinois,0,3,3
127288,2016-05-23,564961,Louisiana,1,2,3
113623,2016-02-25,512239,Nevada,1,2,3
204869,2017-08-22,918499,Louisiana,1,2,3
35034,2014-09-04,185647,North Carolina,2,1,3
31224,2014-08-12,173516,Wisconsin,0,3,3
41596,2014-10-13,206022,Oklahoma,3,0,3
210654,2017-09-27,943925,Arkansas,0,3,3
35766,2014-09-08,187523,Pennsylvania,1,2,3
4106,2014-01-27,101216,Ohio,2,1,3
204651,2017-08-20,916888,Illinois,1,2,3
113728,2016-02-26,512591,Illinois,0,3,3
105508,2015-12-30,476209,Delaware,0,3,3
225657,2017-12-30,1016980,Nevada,3,0,3
204611,2017-08-20,917530,Illinois,0,3,3
127555,2016-05-24,564833,Illinois,1,2,3
27817,2014-07-23,163776,New York,0,3,3
113750,2016-02-26,512572,Rhode Island,0,3,3
15344,2014-05-01,131221,California,1,2,3
27779,2014-07-23,163347,Mississippi,0,3,3
123865,2016-05-01,551313,District of Columbia,0,3,3
111518,2016-02-09,503025,New York,3,0,3
27714,2014-07-23,164662,Maryland,0,3,3
219748,2017-11-21,993342,Alabama,0,3,3
35707,2014-09-07,186931,Ohio,0,3,3
123850,2016-05-01,552184,Missouri,0,3,3
41725,2014-10-14,206657,Alabama,0,3,3
219774,2017-11-21,993122,Missouri,1,2,3
204546,2017-08-20,917692,Louisiana,0,3,3
219839,2017-11-22,993785,Pennsylvania,1,2,3
31201,2014-08-12,173854,Delaware,0,3,3
225618,2017-12-30,1017291,Missouri,0,3,3
14737,2014-04-26,205239,California,1,2,3
35778,2014-09-08,195083,South Carolina,2,1,3
127396,2016-05-23,564019,Illinois,0,3,3
109005,2016-01-23,491498,Connecticut,0,3,3
225569,2017-12-29,1016447,Texas,3,0,3
15015,2014-04-28,130099,New Jersey,0,3,3
219518,2017-11-20,992725,New Jersey,0,3,3
204814,2017-08-21,917619,Wisconsin,1,2,3
41495,2014-10-13,205636,Missouri,2,1,3
105597,2015-12-31,475982,Florida,2,1,3
12968,2014-04-13,125529,Georgia,3,0,3
204766,2017-08-21,917866,Texas,0,3,3
123895,2016-05-01,552193,Nebraska,0,3,3
826,2014-01-04,94524,New York,0,3,3
118427,2016-03-27,529396,Illinois,0,3,3
127480,2016-05-24,564881,Illinois,0,3,3
120936,2016-04-12,539226,Tennessee,2,1,3
127507,2016-05-24,564681,Illinois,0,3,3
41570,2014-10-13,204909,Georgia,0,3,3
118425,2016-03-27,530076,Michigan,1,2,3
204709,2017-08-21,917895,Texas,0,3,3
225589,2017-12-30,1017946,Florida,0,3,3
22446,2014-06-20,154683,Mississippi,1,2,3
215566,2017-10-26,973900,North Carolina,0,3,3
109020,2016-01-23,491856,Indiana,0,3,3
219253,2017-11-18,991029,Tennessee,1,2,3
205354,2017-08-25,920768,Kentucky,3,0,3
219224,2017-11-18,990785,North Carolina,2,1,3
205950,2017-08-28,922538,Illinois,3,0,3
206065,2017-08-29,923311,Georgia,3,0,3
126944,2016-05-20,563237,Pennsylvania,1,2,3
118694,2016-03-29,530520,Texas,0,3,3
232437,2018-02-12,1047997,Georgia,0,3,3
40547,2014-10-07,202157,Tennessee,1,2,3
40601,2014-10-07,202803,Florida,2,1,3
40604,2014-10-07,202406,Illinois,1,2,3
205965,2017-08-28,928224,Pennsylvania,0,3,3
40605,2014-10-07,278273,Pennsylvania,0,3,3
218877,2017-11-16,990339,West Virginia,1,2,3
13030,2014-04-13,125146,Tennessee,0,3,3
106035,2016-01-02,477532,North Carolina,0,3,3
28237,2014-07-26,164474,Ohio,0,3,3
126992,2016-05-21,563813,Texas,2,1,3
205811,2017-08-27,921595,Iowa,1,2,3
40663,2014-10-07,202608,Louisiana,3,0,3
126996,2016-05-21,563259,Pennsylvania,1,2,3
120751,2016-04-11,892848,New York,3,0,3
28489,2014-07-27,164575,Indiana,0,3,3
210291,2017-09-25,941952,Arizona,1,2,3
225509,2017-12-29,1016462,California,2,1,3
105987,2016-01-02,477602,Oklahoma,2,1,3
105977,2016-01-02,477453,California,3,0,3
215772,2017-10-28,974612,Massachusetts,0,3,3
206066,2017-08-29,923575,Illinois,0,3,3
210266,2017-09-24,941281,Florida,1,2,3
28535,2014-07-27,164448,Kentucky,1,2,3
28538,2014-07-28,164860,Ohio,0,3,3
218638,2017-11-14,988013,Illinois,1,2,3
206176,2017-08-30,929087,Texas,1,2,3
206157,2017-08-30,924068,California,1,2,3
233455,2018-02-19,1052668,Kentucky,3,0,3
206155,2017-08-30,923838,Illinois,0,3,3
210208,2017-09-24,942447,Georgia,1,2,3
218676,2017-11-14,988423,Wisconsin,0,3,3
40447,2014-10-06,201625,Georgia,0,3,3
28623,2014-07-28,165981,North Carolina,0,3,3
30779,2014-08-10,173363,New York,1,2,3
210212,2017-09-24,941116,Ohio,1,2,3
13920,2014-04-20,127653,Alabama,0,3,3
120685,2016-04-11,538979,South Carolina,1,2,3
30807,2014-08-10,173725,Iowa,0,3,3
28586,2014-07-28,165514,Kentucky,2,1,3
218808,2017-11-15,989058,Ohio,2,1,3
108743,2016-01-21,489968,Texas,2,1,3
233663,2018-02-20,1053616,Michigan,3,0,3
40476,2014-10-06,201567,Missouri,2,1,3
225172,2017-12-26,1014737,Nebraska,3,0,3
118738,2016-03-29,531458,Illinois,1,2,3
30834,2014-08-10,172193,Indiana,0,3,3
2815,2014-01-18,97736,South Carolina,0,3,3
3995,2014-01-26,101315,California,0,3,3
215733,2017-10-27,974744,West Virginia,0,3,3
205693,2017-08-27,921805,Maryland,0,3,3
205544,2017-08-26,921690,Indiana,0,3,3
28346,2014-07-26,164520,Pennsylvania,2,1,3
219097,2017-11-17,990588,Ohio,2,1,3
108833,2016-01-22,490696,Georgia,1,2,3
205535,2017-08-26,922265,Ohio,0,3,3
205528,2017-08-26,921480,Illinois,0,3,3
28341,2014-07-26,164777,California,1,2,3
124072,2016-05-02,1049075,California,0,3,3
36014,2014-09-09,188276,Georgia,1,2,3
219174,2017-11-18,991542,Washington,3,0,3
205490,2017-08-25,920678,Tennessee,0,3,3
205474,2017-08-25,920637,Louisiana,0,3,3
41044,2014-10-10,203355,Illinois,0,3,3
41045,2014-10-10,203883,California,2,1,3
205433,2017-08-25,920582,New York,3,0,3
105879,2016-01-01,479184,California,0,3,3
28261,2014-07-26,172108,California,1,2,3
4032,2014-01-27,101295,California,0,3,3
105868,2016-01-01,476568,California,1,2,3
205414,2017-08-25,920940,New York,0,3,3
205411,2017-08-25,920911,Texas,0,3,3
14542,2014-04-25,131258,Arkansas,1,2,3
105848,2016-01-01,476876,Florida,0,3,3
14541,2014-04-25,128999,Illinois,1,2,3
224821,2017-12-24,1013566,New York,0,3,3
127111,2016-05-21,563704,Michigan,0,3,3
118645,2016-03-28,531731,Missouri,0,3,3
205564,2017-08-26,921124,Arkansas,1,2,3
127060,2016-05-21,563424,Illinois,0,3,3
127061,2016-05-21,563428,Illinois,0,3,3
